//MAP CONVERTED BY dmm2tgm.py THIS HEADER COMMENT PREVENTS RECONVERSION, DO NOT REMOVE
"ad" = (
/obj/table/auto,
/obj/random_item_spawner/hat/one_or_zero,
/turf/simulated/floor/plating,
/area/station/maintenance/southeast)
"aw" = (
/obj/disposalpipe/segment/mail/horizontal,
/turf/simulated/floor/stairs/wood{
	dir = 8
	},
/area/station/security/detectives_office_manta)
"aA" = (
/obj/stool/bed,
/obj/item/clothing/suit/bedsheet{
	bcolor = "red";
	icon_state = "bedsheet-red"
	},
/turf/simulated/floor/carpet/grime,
/area/station/security/detectives_office_manta/detectives_bedroom)
"aN" = (
/obj/cable{
	icon_state = "1-8"
	},
/obj/decal/cleanable/dirt/jen,
/turf/simulated/floor/carpet/grime,
/area/station/security/detectives_office_manta/detectives_bedroom)
"bm" = (
/obj/machinery/disposal,
/obj/disposalpipe/trunk{
	dir = 4
	},
/turf/simulated/floor/carpet/grime,
/area/station/security/detectives_office_manta/detectives_bedroom)
"bR" = (
/obj/cable{
	icon_state = "4-8"
	},
/obj/disposalpipe/segment/mail/bent/east,
/turf/simulated/floor/carpet/grime,
/area/station/security/detectives_office_manta)
"bY" = (
/obj/disposalpipe/junction{
	dir = 4
	},
/obj/cable{
	icon_state = "4-9"
	},
/turf/simulated/floor/carpet/grime,
/area/station/security/detectives_office_manta)
"cd" = (
/obj/table/wood/auto,
/obj/item/ammo/bullets/a38{
	pixel_x = -2;
	pixel_y = 6
	},
/obj/item/ammo/bullets/a38/stun{
	pixel_x = 2
	},
/turf/simulated/floor/carpet/grime,
/area/station/security/detectives_office_manta/detectives_bedroom)
"cj" = (
/obj/machinery/firealarm{
	dir = 1;
	pixel_y = -24
	},
/turf/simulated/floor/carpet/grime,
/area/station/security/detectives_office_manta)
"cA" = (
/turf/simulated/floor/carpet/grime,
/area/station/security/detectives_office_manta)
"cS" = (
/obj/machinery/camera{
	c_tag = "autotag";
	dir = 1;
	name = "autoname - SS13";
	tag = ""
	},
/obj/machinery/firealarm{
	dir = 1;
	pixel_y = -24
	},
/turf/simulated/floor/carpet/grime,
/area/station/security/detectives_office_manta/detectives_bedroom)
"dh" = (
/obj/machinery/disposal/small/east,
/obj/disposalpipe/trunk{
	dir = 4
	},
/turf/simulated/floor/carpet/grime,
/area/station/security/detectives_office_manta)
"dH" = (
/obj/table/wood/auto,
/obj/item/reagent_containers/food/snacks/chips{
	pixel_x = -7;
	pixel_y = 4
	},
/obj/item/reagent_containers/food/drinks/mug/random_color{
	pixel_x = 5;
	pixel_y = 10
	},
/obj/item/reagent_containers/food/drinks/mug/random_color{
	pixel_x = 7
	},
/turf/simulated/floor/carpet/grime,
/area/station/security/detectives_office_manta)
"ev" = (
/obj/blind_switch/area/east{
	pixel_y = 5
	},
/obj/machinery/light_switch/east{
	pixel_y = -5
	},
/turf/simulated/floor/carpet/grime,
/area/station/security/detectives_office_manta/detectives_bedroom)
"fT" = (
/obj/reagent_dispensers/foamtank,
/turf/simulated/floor/plating,
/area/station/maintenance/southeast)
"gs" = (
/obj/table/wood/auto,
/obj/machinery/light/lamp/green,
/obj/disposalpipe/segment{
	dir = 4
	},
/turf/simulated/floor/carpet/grime,
/area/station/security/detectives_office_manta)
"gR" = (
/obj/table/auto,
/turf/simulated/floor/plating,
/area/station/maintenance/southeast)
"hh" = (
/obj/rack,
/obj/item/clothing/suit/fire,
/obj/item/clothing/suit/fire{
	pixel_x = 4;
	pixel_y = -2
	},
/obj/item/tank/air,
/obj/item/tank/air{
	pixel_x = 4;
	pixel_y = -2
	},
/obj/item/extinguisher{
	pixel_x = 9
	},
/obj/item/extinguisher{
	pixel_x = 12;
	pixel_y = -3
	},
/obj/item/clothing/mask/gas/emergency{
	pixel_x = 4;
	pixel_y = 5
	},
/obj/item/clothing/mask/gas/emergency{
	pixel_x = 8;
	pixel_y = 3
	},
/obj/item/clothing/head/helmet/hardhat{
	pixel_x = 5;
	pixel_y = 13
	},
/obj/item/clothing/head/helmet/hardhat{
	pixel_x = 9;
	pixel_y = 11
	},
/obj/item/crowbar{
	pixel_x = -3;
	pixel_y = 2
	},
/turf/simulated/floor/plating,
/area/station/maintenance/southeast)
"hN" = (
/obj/table/wood/auto,
/obj/machinery/light/lamp/green,
/turf/simulated/floor/carpet/grime,
/area/station/security/detectives_office_manta/detectives_bedroom)
"ic" = (
/obj/machinery/computer/secure_data/detective_computer,
/turf/simulated/floor/carpet/grime,
/area/station/security/detectives_office_manta)
"iL" = (
/obj/cable{
	icon_state = "1-2"
	},
/obj/disposalpipe/segment{
	dir = 4
	},
/turf/simulated/floor/plating,
/area/station/maintenance/southeast)
"iU" = (
/obj/disposalpipe/segment/mail/horizontal,
/turf/simulated/floor/carpet/grime,
/area/station/security/detectives_office_manta)
"jA" = (
/obj/cable{
	icon_state = "4-8"
	},
/obj/disposalpipe/segment/mail/horizontal,
/turf/simulated/floor/carpet/grime,
/area/station/security/detectives_office_manta)
"jV" = (
/obj/table/wood/auto,
/obj/item/device/detective_scanner{
	pixel_x = -4;
	pixel_y = 4
	},
/obj/item/device/detective_scanner{
	pixel_x = 4
	},
/turf/simulated/floor/carpet/grime,
/area/station/security/detectives_office_manta/detectives_bedroom)
"kq" = (
/obj/machinery/camera{
	c_tag = "autotag";
	dir = 4;
	name = "autoname - SS13";
	tag = ""
	},
/turf/simulated/floor/plating,
/area/station/maintenance/southeast)
"kz" = (
/obj/machinery/door/airlock/pyro/security{
	dir = 4;
	name = "Detective's Office";
	req_access = null
	},
/obj/access_spawn/forensics,
/obj/disposalpipe/segment{
	dir = 4
	},
/obj/cable{
	icon_state = "4-8"
	},
/obj/disposalpipe/segment{
	dir = 4
	},
/obj/firedoor_spawn,
/turf/simulated/floor/wood/two,
/area/station/security/detectives_office_manta)
"kI" = (
/obj/storage/closet/office,
/turf/simulated/floor/plating,
/area/station/maintenance/southeast)
"lc" = (
/obj/disposalpipe/segment,
/obj/decal/cleanable/dirt/jen,
/turf/simulated/floor/plating,
/area/station/maintenance/southeast)
"lf" = (
/obj/machinery/light/small,
/turf/simulated/floor/carpet/grime,
/area/station/security/detectives_office_manta)
"lA" = (
/obj/machinery/disposal,
/obj/disposalpipe/trunk{
	dir = 8
	},
/turf/simulated/floor/carpet/grime,
/area/station/security/detectives_office_manta)
"lF" = (
/obj/table/wood/auto,
/obj/item/decoration/ashtray{
	butts = 4;
	pixel_x = 6
	},
/obj/item/cigbutt{
	pixel_x = -3;
	pixel_y = -1
	},
/obj/item/cigbutt{
	pixel_x = 3;
	pixel_y = 7
	},
/turf/simulated/floor/carpet/grime,
/area/station/security/detectives_office_manta/detectives_bedroom)
"lL" = (
/obj/item/device/radio/intercom{
	broadcasting = 0;
	dir = 1;
	frequency = 1489;
	name = "Brig Intercom"
	},
/turf/simulated/floor/carpet/grime,
/area/station/security/detectives_office_manta)
"nf" = (
/obj/wingrille_spawn/auto,
/obj/window_blinds/cog2/right{
	dir = 4
	},
/obj/cable{
	icon_state = "0-2"
	},
/turf/simulated/floor/plating,
/area/station/security/detectives_office_manta/detectives_bedroom)
"nh" = (
/obj/disposalpipe/segment,
/obj/cable{
	icon_state = "1-2"
	},
/turf/simulated/floor/carpet/grime,
/area/station/security/detectives_office_manta)
"nC" = (
/turf/space,
/area/space)
"nH" = (
/obj/disposalpipe/segment{
	dir = 4
	},
/obj/disposalpipe/segment/mail/vertical,
/turf/simulated/floor/carpet/grime,
/area/station/security/detectives_office_manta)
"oo" = (
/obj/stool/chair/comfy{
	dir = 4
	},
/obj/disposalpipe/segment/mail/bent/west,
/turf/simulated/floor/carpet/grime,
/area/station/security/detectives_office_manta)
"op" = (
/obj/decal/cleanable/dirt/jen,
/obj/stool/chair/couch{
	dir = 4
	},
/turf/simulated/floor/carpet/grime,
/area/station/security/detectives_office_manta)
"oV" = (
/obj/table/wood/auto,
/obj/deskclutter{
	pixel_x = -6;
	pixel_y = 4
	},
/obj/disposalpipe/segment{
	dir = 4
	},
/turf/simulated/floor/carpet/grime,
/area/station/security/detectives_office_manta)
"pB" = (
/obj/machinery/door/airlock/pyro/security{
	name = "Detective's Room";
	req_access = null
	},
/obj/access_spawn/forensics,
/obj/disposalpipe/segment,
/obj/cable{
	icon_state = "1-2"
	},
/obj/firedoor_spawn,
/turf/simulated/floor/wood/two,
/area/station/security/detectives_office_manta/detectives_bedroom)
"pN" = (
/obj/decal/cleanable/dirt/jen,
/turf/simulated/floor/plating,
/area/station/maintenance/southeast)
"pR" = (
/turf/simulated/wall/auto/reinforced/supernorn,
/area/station/security/detectives_office_manta/detectives_bedroom)
"pU" = (
/obj/disposalpipe/segment{
	dir = 4
	},
/obj/decal/cleanable/dirt/jen,
/turf/simulated/floor/plating,
/area/station/maintenance/southeast)
"qw" = (
/obj/machinery/door/airlock/pyro/maintenance{
	dir = 4;
	req_access = null
	},
/obj/firedoor_spawn,
/obj/cable{
	icon_state = "4-8"
	},
/turf/simulated/floor/plating,
/area/station/maintenance/southeast)
"qI" = (
/obj/cable{
	icon_state = "1-2"
	},
/turf/simulated/floor/plating,
/area/station/maintenance/southeast)
"rJ" = (
/obj/random_item_spawner/junk/one_or_zero,
/turf/simulated/floor/plating,
/area/station/maintenance/southeast)
"rR" = (
/obj/table/wood/auto,
/obj/item/reagent_containers/food/drinks/bottle/bojackson{
	pixel_x = -6;
	pixel_y = 8
	},
/obj/item/device/light/zippo{
	pixel_x = 5;
	pixel_y = 7
	},
/obj/item/cigpacket/propuffs{
	pixel_x = 7;
	pixel_y = 2
	},
/turf/simulated/floor/carpet/grime,
/area/station/security/detectives_office_manta/detectives_bedroom)
"sA" = (
/obj/disposalpipe/segment{
	dir = 4
	},
/turf/simulated/floor/plating,
/area/station/maintenance/southeast)
"sF" = (
/obj/table/wood/auto,
/obj/item/device/audio_log{
	pixel_x = -2;
	pixel_y = 6
	},
/obj/item/device/audio_log{
	pixel_x = 2;
	pixel_y = 2
	},
/turf/simulated/floor/carpet/grime,
/area/station/security/detectives_office_manta)
"sP" = (
/obj/storage/closet/emergency,
/turf/simulated/floor/plating,
/area/station/maintenance/southeast)
"sR" = (
/obj/table/wood/auto,
/obj/item/paper_bin{
	pixel_y = 4
	},
/obj/item/pen{
	pixel_x = -5;
	pixel_y = 5
	},
/obj/item/pen{
	pixel_x = 5;
	pixel_y = 5
	},
/turf/simulated/floor/carpet/grime,
/area/station/security/detectives_office_manta)
"sT" = (
/obj/stool/chair/couch{
	dir = 8
	},
/obj/machinery/light/small{
	dir = 1
	},
/turf/simulated/floor/carpet/grime,
/area/station/security/detectives_office_manta)
"tV" = (
/obj/disposalpipe/segment{
	dir = 4
	},
/obj/machinery/firealarm{
	dir = 1;
	pixel_y = -24
	},
/turf/simulated/floor/plating,
/area/station/maintenance/southeast)
"uF" = (
/obj/table/wood/auto,
/obj/item/device/camera_viewer,
/obj/item/camera_test,
/obj/cable{
	icon_state = "6-8"
	},
/turf/simulated/floor/carpet/grime,
/area/station/security/detectives_office_manta/detectives_bedroom)
"uM" = (
/obj/table/wood/auto,
/obj/item/decoration/ashtray{
	butts = 2
	},
/obj/item/cigbutt{
	pixel_x = -4;
	pixel_y = 7
	},
/turf/simulated/floor/carpet/grime,
/area/station/security/detectives_office_manta)
"vl" = (
/obj/cable{
	icon_state = "2-9"
	},
/obj/disposalpipe/segment,
/turf/simulated/floor/plating,
/area/station/maintenance/southeast)
"vJ" = (
/obj/cable{
	icon_state = "1-6"
	},
/turf/simulated/floor/plating,
/area/station/maintenance/southeast)
"wk" = (
/obj/disposalpipe/segment{
	dir = 1;
	icon_state = "pipe-c"
	},
/turf/simulated/floor/carpet/grime,
/area/station/security/detectives_office_manta)
"ws" = (
/obj/machinery/computer3/generic/secure_data{
	dir = 8
	},
/obj/machinery/power/data_terminal,
/obj/cable{
	icon_state = "0-6"
	},
/turf/simulated/floor/carpet/grime,
/area/station/security/detectives_office_manta/detectives_bedroom)
"wI" = (
/obj/cable{
	icon_state = "6-8"
	},
/turf/simulated/floor/plating,
/area/station/maintenance/southeast)
"xb" = (
/obj/stool/chair/comfy{
	dir = 8
	},
/turf/simulated/floor/carpet/grime,
/area/station/security/detectives_office_manta/detectives_bedroom)
"xm" = (
/obj/storage/cart/forensic{
	req_access_txt = "4"
	},
/obj/machinery/light/small{
	dir = 4
	},
/turf/simulated/floor/carpet/grime,
/area/station/security/detectives_office_manta)
"xv" = (
/obj/item/device/radio/intercom{
	broadcasting = 0;
	dir = 4;
	frequency = 1485;
	name = "Security Intercom"
	},
/turf/simulated/floor/carpet/grime,
/area/station/security/detectives_office_manta)
"xz" = (
/obj/machinery/light/small{
	dir = 4
	},
/turf/simulated/floor/carpet/grime,
/area/station/security/detectives_office_manta/detectives_bedroom)
"ym" = (
/obj/cable{
	icon_state = "6-9"
	},
/obj/cable{
	icon_state = "1-6"
	},
/turf/simulated/floor/plating,
/area/station/maintenance/southeast)
"yA" = (
/obj/cable{
	icon_state = "5-8"
	},
/obj/decal/cleanable/dirt/jen,
/turf/simulated/floor/plating,
/area/station/maintenance/southeast)
"yZ" = (
/obj/machinery/light/small{
	dir = 4
	},
/turf/simulated/floor/plating,
/area/station/maintenance/southeast)
"zo" = (
/obj/machinery/power/apc/autoname_east,
/obj/cable{
	icon_state = "0-9"
	},
/turf/simulated/floor/plating,
/area/station/maintenance/southeast)
"AG" = (
/obj/cable{
	icon_state = "4-8"
	},
/turf/simulated/floor/plating,
/area/station/maintenance/southeast)
"Bj" = (
/obj/stool/chair/couch,
/turf/simulated/floor/carpet/grime,
/area/station/security/detectives_office_manta)
"Br" = (
/obj/shrub{
	dir = 1;
	icon = 'icons/obj/stationobjs.dmi';
	icon_state = "plant"
	},
/turf/simulated/floor/carpet/grime,
/area/station/security/detectives_office_manta)
"BN" = (
/obj/cable{
	icon_state = "1-2"
	},
/obj/cable{
	icon_state = "2-8"
	},
/turf/simulated/floor/plating,
/area/station/maintenance/southeast)
"BP" = (
/obj/table/auto,
/obj/random_item_spawner/junk/one_or_zero,
/turf/simulated/floor/plating,
/area/station/maintenance/southeast)
"Cu" = (
/obj/cable{
	icon_state = "2-8"
	},
/obj/machinery/light/small{
	dir = 4
	},
/obj/disposalpipe/segment/mail/bent/west,
/turf/simulated/floor/carpet/grime,
/area/station/security/detectives_office_manta)
"Dv" = (
/obj/cable{
	icon_state = "4-8"
	},
/turf/simulated/floor/carpet/grime,
/area/station/security/detectives_office_manta)
"El" = (
/obj/cable{
	icon_state = "1-2"
	},
/obj/cable{
	icon_state = "1-8"
	},
/obj/disposalpipe/segment{
	dir = 8;
	icon_state = "pipe-c"
	},
/turf/simulated/floor/plating,
/area/station/maintenance/southeast)
"Eq" = (
/obj/decoration/ceilingfan,
/turf/simulated/floor/carpet/grime,
/area/station/security/detectives_office_manta)
"Fj" = (
/obj/machinery/light/small{
	dir = 1
	},
/turf/simulated/floor/carpet/grime,
/area/station/security/detectives_office_manta/detectives_bedroom)
"FB" = (
/turf/simulated/wall/auto/reinforced/supernorn,
/area/station/security/detectives_office_manta)
"Ga" = (
/obj/disposalpipe/segment{
	dir = 4
	},
/obj/machinery/door/airlock/pyro/maintenance{
	dir = 4;
	req_access = null
	},
/obj/firedoor_spawn,
/turf/simulated/floor/plating,
/area/station/maintenance/southeast)
"Gl" = (
/obj/machinery/door/airlock/pyro/security{
	dir = 4;
	name = "Detective's Office";
	req_access = null
	},
/obj/access_spawn/forensics,
/obj/disposalpipe/segment/mail/horizontal,
/obj/firedoor_spawn,
/turf/simulated/floor/wood/two,
/area/station/security/detectives_office_manta)
"Gt" = (
/obj/critter/roach,
/turf/simulated/floor/plating,
/area/station/maintenance/southeast)
"GY" = (
/obj/machinery/firealarm{
	dir = 4;
	pixel_x = 24
	},
/turf/simulated/floor/stairs,
/area/station/maintenance/southeast)
"Hl" = (
/obj/disposalpipe/segment{
	dir = 8;
	icon_state = "pipe-c"
	},
/obj/cable{
	icon_state = "1-10"
	},
/obj/cable{
	icon_state = "1-2"
	},
/turf/simulated/floor/stairs/wood,
/area/station/security/detectives_office_manta/detectives_bedroom)
"HF" = (
/obj/cable{
	icon_state = "4-8"
	},
/turf/simulated/floor/carpet/grime,
/area/station/security/detectives_office_manta/detectives_bedroom)
"HO" = (
/obj/disposalpipe/junction{
	icon_state = "pipe-j2"
	},
/obj/cable{
	icon_state = "1-6"
	},
/turf/simulated/floor/carpet/grime,
/area/station/security/detectives_office_manta)
"Ij" = (
/obj/storage/cart/forensic{
	req_access_txt = "4"
	},
/obj/machinery/camera{
	c_tag = "autotag";
	dir = 8;
	name = "autoname - SS13";
	tag = ""
	},
/turf/simulated/floor/carpet/grime,
/area/station/security/detectives_office_manta)
"II" = (
/obj/shrub{
	icon = 'icons/obj/stationobjs.dmi';
	icon_state = "plant"
	},
/turf/simulated/floor/carpet/grime,
/area/station/security/detectives_office_manta/detectives_bedroom)
"IJ" = (
/obj/storage/secure/closet/security/forensics,
/turf/simulated/floor/carpet/grime,
/area/station/security/detectives_office_manta/detectives_bedroom)
"Jd" = (
/obj/disposalpipe/segment/mail/vertical,
/turf/simulated/floor/carpet/grime,
/area/station/security/detectives_office_manta)
"Kp" = (
/obj/stool/chair{
	dir = 4
	},
/turf/simulated/floor/carpet/grime,
/area/station/security/detectives_office_manta/detectives_bedroom)
"KR" = (
/obj/table/wood/auto,
/turf/simulated/floor/carpet/grime,
/area/station/security/detectives_office_manta)
"Ly" = (
/obj/wingrille_spawn/auto,
/obj/window_blinds/cog2/left{
	dir = 4
	},
/obj/cable{
	d2 = 4;
	icon_state = "0-4"
	},
/obj/cable,
/turf/simulated/floor/plating,
/area/station/security/detectives_office_manta)
"LR" = (
/turf/simulated/floor/carpet/grime,
/area/station/security/detectives_office_manta/detectives_bedroom)
"Mj" = (
/obj/disposalpipe/segment,
/turf/simulated/floor/plating,
/area/station/maintenance/southeast)
"Mr" = (
/obj/disposalpipe/junction{
	dir = 1;
	icon_state = "pipe-j2"
	},
/turf/simulated/floor/plating,
/area/station/maintenance/southeast)
"Mu" = (
/obj/wingrille_spawn/auto,
/obj/window_blinds/cog2/left{
	dir = 4
	},
/obj/cable{
	d2 = 4;
	icon_state = "0-4"
	},
/obj/cable,
/turf/simulated/floor/plating,
/area/station/security/detectives_office_manta/detectives_bedroom)
"MW" = (
/obj/wingrille_spawn/auto,
/obj/window_blinds/cog2/right{
	dir = 4
	},
/obj/cable{
	icon_state = "0-2"
	},
/turf/simulated/floor/plating,
/area/station/security/detectives_office_manta)
"Ok" = (
/obj/stool/chair{
	dir = 4
	},
/turf/simulated/floor/plating,
/area/station/maintenance/southeast)
"Ow" = (
/obj/cable{
	icon_state = "1-10"
	},
/turf/simulated/floor/plating,
/area/station/maintenance/southeast)
"Oy" = (
/obj/machinery/disposal/mail{
	mail_tag = "detective";
	mailgroup = "security";
	message = "1";
	name = "mail chute-'Detective'"
	},
/obj/disposalpipe/trunk/mail,
/turf/simulated/floor/carpet/grime,
/area/station/security/detectives_office_manta)
"OD" = (
/obj/machinery/computer/security/wooden_tv,
/obj/item/clothing/head/fedora{
	pixel_y = 11
	},
/turf/simulated/floor/carpet/grime,
/area/station/security/detectives_office_manta)
"OK" = (
/obj/machinery/camera{
	c_tag = "autotag";
	dir = 6;
	name = "autoname - SS13";
	tag = ""
	},
/obj/cable{
	icon_state = "4-8"
	},
/turf/simulated/floor/plating,
/area/station/maintenance/southeast)
"Pi" = (
/obj/machinery/vending/security,
/turf/simulated/floor/carpet/grime,
/area/station/security/detectives_office_manta/detectives_bedroom)
"Pj" = (
/obj/decal/cleanable/dirt/jen,
/turf/simulated/floor/carpet/grime,
/area/station/security/detectives_office_manta/detectives_bedroom)
"Pq" = (
/obj/stool/chair/comfy{
	dir = 8
	},
/turf/simulated/floor/carpet/grime,
/area/station/security/detectives_office_manta)
"PC" = (
/obj/cable{
	icon_state = "2-9"
	},
/turf/simulated/floor/plating,
/area/station/maintenance/southeast)
"Qd" = (
/obj/machinery/light/small{
	dir = 8
	},
/turf/simulated/floor/plating,
/area/station/maintenance/southeast)
"RT" = (
/obj/table/wood/auto,
/obj/item/storage/box/evidence,
/turf/simulated/floor/carpet/grime,
/area/station/security/detectives_office_manta/detectives_bedroom)
"Sg" = (
/obj/machinery/light/small,
/obj/decal/cleanable/dirt/jen,
/turf/simulated/floor/carpet/grime,
/area/station/security/detectives_office_manta/detectives_bedroom)
"Sw" = (
/obj/machinery/light/small{
	dir = 1
	},
/obj/cable{
	icon_state = "4-8"
	},
/turf/simulated/floor/plating,
/area/station/maintenance/southeast)
"SP" = (
/obj/disposalpipe/segment{
	dir = 4
	},
/obj/cable{
	icon_state = "4-10"
	},
/obj/cable{
	icon_state = "4-8"
	},
/turf/simulated/floor/carpet/grime,
/area/station/security/detectives_office_manta)
"TD" = (
/turf/simulated/wall/auto/supernorn,
/area/station/maintenance/southeast)
"Ub" = (
/obj/cable{
	icon_state = "1-2"
	},
/turf/simulated/floor/stairs,
/area/station/maintenance/southeast)
"US" = (
/turf/simulated/wall/auto/reinforced/supernorn,
/area/station/maintenance/southeast)
"UY" = (
/obj/wingrille_spawn/auto,
/turf/simulated/floor/plating,
/area/station/maintenance/southeast)
"Vz" = (
/obj/cable{
	icon_state = "5-9"
	},
/obj/cable{
	icon_state = "4-8"
	},
/turf/simulated/floor/carpet/grime,
/area/station/security/detectives_office_manta/detectives_bedroom)
"VI" = (
/obj/disposalpipe/segment{
	dir = 2;
	icon_state = "pipe-c"
	},
/obj/cable{
	icon_state = "1-2"
	},
/obj/machinery/light_switch/east{
	pixel_y = -5
	},
/obj/blind_switch/area/east{
	pixel_y = 5
	},
/turf/simulated/floor/stairs/wood{
	dir = 1
	},
/area/station/security/detectives_office_manta)
"VU" = (
/obj/cable{
	icon_state = "4-9"
	},
/turf/simulated/floor/carpet/grime,
/area/station/security/detectives_office_manta/detectives_bedroom)
"WF" = (
/obj/decal/cleanable/cobweb2,
/turf/simulated/floor/plating,
/area/station/maintenance/southeast)
"WS" = (
/obj/decal/cleanable/dirt/jen,
/obj/cable{
	icon_state = "4-8"
	},
/turf/simulated/floor/plating,
/area/station/maintenance/southeast)
"WT" = (
/turf/simulated/floor/plating,
/area/station/maintenance/southeast)
"Xt" = (
/obj/cable{
	icon_state = "1-2"
	},
/obj/cable{
	icon_state = "1-6"
	},
/obj/disposalpipe/segment,
/turf/simulated/floor/plating,
/area/station/maintenance/southeast)
"Xw" = (
/obj/machinery/power/apc/autoname_west,
/obj/cable{
	d2 = 4;
	icon_state = "0-4"
	},
/turf/simulated/floor/plating,
/area/station/maintenance/southeast)
"XJ" = (
/obj/decal/cleanable/dirt/jen,
/turf/simulated/floor/carpet/grime,
/area/station/security/detectives_office_manta)
"XY" = (
/obj/cable{
	icon_state = "1-2"
	},
/obj/decal/cleanable/dirt/jen,
/turf/simulated/floor/plating,
/area/station/maintenance/southeast)
"Yi" = (
/obj/random_item_spawner/junk/one_or_zero,
/obj/cable{
	icon_state = "4-8"
	},
/obj/decal/cleanable/dirt/jen,
/turf/simulated/floor/plating,
/area/station/maintenance/southeast)
"ZG" = (
/obj/disposalpipe/segment,
/obj/cable{
	icon_state = "2-5"
	},
/turf/simulated/floor/carpet/grime,
/area/station/security/detectives_office_manta)
"ZY" = (
/obj/cable{
	icon_state = "4-8"
	},
/obj/disposalpipe/segment{
	dir = 4
	},
/turf/simulated/floor/plating,
/area/station/maintenance/southeast)

(1,1,1) = {"
nC
nC
nC
nC
nC
nC
nC
nC
nC
nC
nC
nC
nC
nC
nC
nC
nC
nC
nC
nC
nC
nC
nC
nC
nC
nC
nC
nC
nC
nC
nC
nC
nC
nC
nC
nC
nC
nC
nC
nC
"}
(2,1,1) = {"
nC
nC
nC
nC
nC
nC
nC
nC
nC
nC
nC
nC
nC
nC
nC
nC
nC
nC
nC
nC
nC
nC
nC
nC
nC
nC
nC
nC
nC
nC
nC
nC
nC
nC
nC
nC
nC
nC
nC
nC
"}
(3,1,1) = {"
nC
nC
nC
nC
nC
nC
nC
nC
nC
nC
nC
nC
nC
nC
nC
nC
nC
nC
nC
nC
nC
nC
nC
nC
nC
nC
nC
nC
nC
nC
nC
nC
nC
nC
nC
nC
nC
nC
nC
nC
"}
(4,1,1) = {"
nC
nC
nC
nC
nC
nC
nC
nC
nC
nC
nC
nC
nC
nC
nC
nC
nC
nC
nC
nC
nC
nC
nC
nC
nC
nC
nC
nC
nC
nC
nC
nC
nC
nC
nC
nC
nC
nC
nC
nC
"}
(5,1,1) = {"
nC
nC
nC
nC
nC
nC
nC
nC
nC
nC
nC
nC
nC
nC
nC
nC
nC
nC
nC
nC
nC
nC
nC
nC
nC
nC
nC
nC
nC
nC
nC
nC
nC
nC
nC
nC
nC
nC
nC
nC
"}
(6,1,1) = {"
nC
nC
nC
nC
nC
nC
nC
nC
nC
nC
nC
nC
nC
nC
nC
nC
nC
nC
nC
nC
nC
nC
nC
nC
nC
nC
nC
nC
nC
nC
nC
nC
nC
nC
nC
nC
nC
nC
nC
nC
"}
(7,1,1) = {"
nC
nC
nC
nC
nC
nC
nC
nC
nC
nC
nC
nC
nC
nC
nC
nC
nC
nC
nC
nC
nC
nC
nC
nC
nC
nC
nC
nC
nC
nC
nC
nC
nC
nC
nC
nC
nC
nC
nC
nC
"}
(8,1,1) = {"
nC
nC
nC
nC
nC
nC
nC
nC
nC
nC
nC
nC
nC
nC
nC
nC
nC
nC
nC
nC
nC
nC
nC
nC
nC
nC
nC
nC
nC
nC
nC
nC
nC
nC
nC
nC
nC
nC
nC
nC
"}
(9,1,1) = {"
nC
nC
nC
nC
nC
nC
nC
nC
nC
nC
nC
nC
nC
nC
nC
nC
nC
nC
nC
nC
nC
nC
nC
nC
nC
nC
nC
nC
nC
nC
nC
nC
nC
nC
nC
nC
nC
nC
nC
nC
"}
(10,1,1) = {"
nC
nC
nC
nC
nC
nC
nC
nC
nC
nC
nC
nC
nC
nC
nC
nC
nC
nC
nC
nC
nC
nC
nC
nC
nC
nC
nC
nC
nC
nC
nC
nC
nC
nC
nC
nC
nC
nC
nC
nC
"}
(11,1,1) = {"
nC
nC
nC
nC
nC
nC
nC
nC
nC
nC
nC
nC
nC
nC
nC
FB
FB
Gl
FB
pR
pR
nf
Mu
pR
pR
nC
nC
nC
nC
nC
nC
nC
nC
nC
nC
nC
nC
nC
nC
nC
"}
(12,1,1) = {"
nC
nC
nC
nC
nC
nC
nC
nC
nC
nC
nC
nC
FB
MW
Ly
FB
cA
aw
Br
pR
jV
cd
uF
hN
pR
pR
nC
nC
nC
nC
nC
nC
nC
nC
nC
nC
nC
nC
nC
nC
"}
(13,1,1) = {"
nC
nC
nC
nC
nC
nC
nC
nC
nC
TD
qw
Ga
FB
sT
Dv
dh
XJ
iU
lf
pR
Fj
xb
Pj
VU
rR
pR
nC
nC
nC
nC
nC
nC
nC
nC
nC
nC
nC
nC
nC
nC
"}
(14,1,1) = {"
nC
nC
nC
nC
nC
nC
nC
nC
nC
TD
Yi
sA
FB
Bj
bR
nH
Jd
oo
cj
pR
IJ
ev
LR
HF
aA
pR
nC
nC
nC
nC
nC
nC
nC
nC
nC
nC
nC
nC
nC
nC
"}
(15,1,1) = {"
nC
nC
nC
nC
nC
nC
nC
nC
nC
TD
Sw
pU
FB
op
jA
gs
uM
KR
sR
pR
pR
pR
Kp
HF
Sg
pR
nC
nC
nC
nC
nC
nC
nC
nC
nC
nC
nC
nC
nC
nC
"}
(16,1,1) = {"
nC
nC
nC
nC
nC
nC
nC
nC
nC
TD
WS
sA
FB
dH
jA
oV
cA
Pq
cA
xv
OD
pR
ws
HF
cS
pR
nC
nC
nC
nC
nC
nC
nC
nC
nC
nC
nC
nC
nC
nC
"}
(17,1,1) = {"
nC
nC
nC
nC
nC
nC
nC
nC
nC
TD
AG
tV
FB
Oy
Cu
VI
HO
wk
Eq
XJ
lL
pR
bm
Vz
II
pR
nC
nC
nC
nC
nC
nC
nC
nC
nC
nC
nC
nC
nC
nC
"}
(18,1,1) = {"
nC
nC
nC
nC
nC
nC
nC
nC
nC
TD
OK
sA
FB
FB
FB
FB
lA
bY
ZG
nh
nh
pB
Hl
aN
lF
pR
nC
nC
nC
nC
nC
nC
nC
nC
nC
nC
nC
nC
nC
nC
"}
(19,1,1) = {"
nC
nC
nC
nC
nC
nC
nC
nC
nC
TD
AG
sA
rJ
Xw
sP
FB
sF
SP
Ij
xm
ic
pR
Pi
xz
RT
pR
nC
nC
nC
nC
nC
nC
nC
nC
nC
nC
nC
nC
nC
nC
"}
(20,1,1) = {"
nC
nC
nC
nC
nC
nC
nC
nC
nC
TD
AG
sA
WT
wI
pN
FB
FB
kz
FB
FB
FB
pR
pR
pR
pR
pR
US
nC
nC
nC
nC
nC
nC
nC
nC
nC
nC
nC
nC
nC
"}
(21,1,1) = {"
nC
nC
nC
nC
nC
nC
nC
nC
nC
qI
BN
iL
XY
qI
ym
pN
WT
ZY
kq
US
fT
WT
Qd
Xw
WT
rJ
US
nC
nC
nC
nC
nC
nC
nC
nC
nC
nC
nC
nC
nC
"}
(22,1,1) = {"
nC
nC
nC
nC
nC
nC
nC
nC
nC
lc
Mj
Mr
Mj
Mj
Mj
vl
Xt
El
qI
Ub
vJ
WT
pN
yA
Gt
WT
UY
nC
nC
nC
nC
nC
nC
nC
nC
nC
nC
nC
nC
nC
"}
(23,1,1) = {"
nC
nC
nC
nC
nC
nC
nC
nC
nC
US
US
hh
pN
WT
WT
yZ
WT
zo
pN
GY
WT
PC
Ow
WT
WT
WT
UY
nC
nC
nC
nC
nC
nC
nC
nC
nC
nC
nC
nC
nC
"}
(24,1,1) = {"
nC
nC
nC
nC
nC
nC
nC
nC
nC
nC
US
US
UY
UY
UY
US
US
US
US
US
WF
pN
Ok
WT
WT
kI
US
nC
nC
nC
nC
nC
nC
nC
nC
nC
nC
nC
nC
nC
"}
(25,1,1) = {"
nC
nC
nC
nC
nC
nC
nC
nC
nC
nC
nC
nC
nC
nC
nC
nC
nC
nC
nC
US
US
gR
BP
gR
ad
US
US
nC
nC
nC
nC
nC
nC
nC
nC
nC
nC
nC
nC
nC
"}
(26,1,1) = {"
nC
nC
nC
nC
nC
nC
nC
nC
nC
nC
nC
nC
nC
nC
nC
nC
nC
nC
nC
nC
US
US
UY
UY
US
US
nC
nC
nC
nC
nC
nC
nC
nC
nC
nC
nC
nC
nC
nC
"}
(27,1,1) = {"
nC
nC
nC
nC
nC
nC
nC
nC
nC
nC
nC
nC
nC
nC
nC
nC
nC
nC
nC
nC
nC
nC
nC
nC
nC
nC
nC
nC
nC
nC
nC
nC
nC
nC
nC
nC
nC
nC
nC
nC
"}
(28,1,1) = {"
nC
nC
nC
nC
nC
nC
nC
nC
nC
nC
nC
nC
nC
nC
nC
nC
nC
nC
nC
nC
nC
nC
nC
nC
nC
nC
nC
nC
nC
nC
nC
nC
nC
nC
nC
nC
nC
nC
nC
nC
"}
(29,1,1) = {"
nC
nC
nC
nC
nC
nC
nC
nC
nC
nC
nC
nC
nC
nC
nC
nC
nC
nC
nC
nC
nC
nC
nC
nC
nC
nC
nC
nC
nC
nC
nC
nC
nC
nC
nC
nC
nC
nC
nC
nC
"}
(30,1,1) = {"
nC
nC
nC
nC
nC
nC
nC
nC
nC
nC
nC
nC
nC
nC
nC
nC
nC
nC
nC
nC
nC
nC
nC
nC
nC
nC
nC
nC
nC
nC
nC
nC
nC
nC
nC
nC
nC
nC
nC
nC
"}
(31,1,1) = {"
nC
nC
nC
nC
nC
nC
nC
nC
nC
nC
nC
nC
nC
nC
nC
nC
nC
nC
nC
nC
nC
nC
nC
nC
nC
nC
nC
nC
nC
nC
nC
nC
nC
nC
nC
nC
nC
nC
nC
nC
"}
(32,1,1) = {"
nC
nC
nC
nC
nC
nC
nC
nC
nC
nC
nC
nC
nC
nC
nC
nC
nC
nC
nC
nC
nC
nC
nC
nC
nC
nC
nC
nC
nC
nC
nC
nC
nC
nC
nC
nC
nC
nC
nC
nC
"}
(33,1,1) = {"
nC
nC
nC
nC
nC
nC
nC
nC
nC
nC
nC
nC
nC
nC
nC
nC
nC
nC
nC
nC
nC
nC
nC
nC
nC
nC
nC
nC
nC
nC
nC
nC
nC
nC
nC
nC
nC
nC
nC
nC
"}
(34,1,1) = {"
nC
nC
nC
nC
nC
nC
nC
nC
nC
nC
nC
nC
nC
nC
nC
nC
nC
nC
nC
nC
nC
nC
nC
nC
nC
nC
nC
nC
nC
nC
nC
nC
nC
nC
nC
nC
nC
nC
nC
nC
"}
(35,1,1) = {"
nC
nC
nC
nC
nC
nC
nC
nC
nC
nC
nC
nC
nC
nC
nC
nC
nC
nC
nC
nC
nC
nC
nC
nC
nC
nC
nC
nC
nC
nC
nC
nC
nC
nC
nC
nC
nC
nC
nC
nC
"}
(36,1,1) = {"
nC
nC
nC
nC
nC
nC
nC
nC
nC
nC
nC
nC
nC
nC
nC
nC
nC
nC
nC
nC
nC
nC
nC
nC
nC
nC
nC
nC
nC
nC
nC
nC
nC
nC
nC
nC
nC
nC
nC
nC
"}
(37,1,1) = {"
nC
nC
nC
nC
nC
nC
nC
nC
nC
nC
nC
nC
nC
nC
nC
nC
nC
nC
nC
nC
nC
nC
nC
nC
nC
nC
nC
nC
nC
nC
nC
nC
nC
nC
nC
nC
nC
nC
nC
nC
"}
(38,1,1) = {"
nC
nC
nC
nC
nC
nC
nC
nC
nC
nC
nC
nC
nC
nC
nC
nC
nC
nC
nC
nC
nC
nC
nC
nC
nC
nC
nC
nC
nC
nC
nC
nC
nC
nC
nC
nC
nC
nC
nC
nC
"}
(39,1,1) = {"
nC
nC
nC
nC
nC
nC
nC
nC
nC
nC
nC
nC
nC
nC
nC
nC
nC
nC
nC
nC
nC
nC
nC
nC
nC
nC
nC
nC
nC
nC
nC
nC
nC
nC
nC
nC
nC
nC
nC
nC
"}
(40,1,1) = {"
nC
nC
nC
nC
nC
nC
nC
nC
nC
nC
nC
nC
nC
nC
nC
nC
nC
nC
nC
nC
nC
nC
nC
nC
nC
nC
nC
nC
nC
nC
nC
nC
nC
nC
nC
nC
nC
nC
nC
nC
"}
