//MAP CONVERTED BY dmm2tgm.py THIS HEADER COMMENT PREVENTS RECONVERSION, DO NOT REMOVE
"bB" = (
/obj/reagent_dispensers/watertank/fountain,
/turf/simulated/floor/wood,
/area/station/crew_quarters/courtroom)
"bI" = (
/turf/simulated/floor/carpet/red/fancy/edge/ne,
/area/station/crew_quarters/courtroom)
"cl" = (
/turf/simulated/floor/wood,
/area/station/crew_quarters/courtroom)
"cK" = (
/obj/table/wood/auto,
/obj/item/clipboard/with_pen{
	pixel_y = 4
	},
/obj/item/paper_bin{
	pixel_y = 3
	},
/obj/item/pen{
	pixel_y = 4
	},
/turf/simulated/floor/carpet/red/fancy/edge/se,
/area/station/crew_quarters/courtroom)
"dc" = (
/obj/stool/chair/office,
/obj/machinery/light/incandescent{
	dir = 4
	},
/turf/simulated/floor/wood,
/area/station/crew_quarters/courtroom)
"eF" = (
/obj/stool/chair/office{
	dir = 8
	},
/obj/decoration/clock{
	pixel_y = 32
	},
/turf/simulated/floor/carpet/green/fancy/edge/ne,
/area/station/crew_quarters/courtroom)
"fg" = (
/obj/stool/chair/office,
/turf/simulated/floor/wood,
/area/station/crew_quarters/courtroom)
"fl" = (
/obj/wingrille_spawn/auto,
/obj/window_blinds/cog2,
/turf/simulated/floor/plating,
/area/station/crew_quarters/courtroom)
"fP" = (
/obj/storage/closet/law,
/turf/simulated/floor/wood,
/area/station/crew_quarters/courtroom)
"gq" = (
/obj/machinery/light/incandescent{
	dir = 8
	},
/turf/simulated/floor/wood,
/area/station/crew_quarters/courtroom)
"in" = (
/obj/stool/chair/office{
	dir = 4
	},
/turf/simulated/floor/carpet/green/fancy/edge/nw,
/area/station/crew_quarters/courtroom)
"ip" = (
/turf/simulated/floor/carpet/blue/fancy/edge,
/area/station/crew_quarters/courtroom)
"iy" = (
/obj/stool/chair/office{
	dir = 4
	},
/obj/machinery/light/incandescent{
	dir = 8
	},
/turf/simulated/floor/carpet/green/fancy/edge/west,
/area/station/crew_quarters/courtroom)
"jE" = (
/obj/stool/chair/office,
/obj/machinery/light/incandescent{
	dir = 8
	},
/turf/simulated/floor/wood,
/area/station/crew_quarters/courtroom)
"kn" = (
/obj/stool/chair/office{
	dir = 8
	},
/obj/item/device/radio/intercom/security{
	dir = 8
	},
/turf/simulated/floor/carpet/green/fancy/edge/east,
/area/station/crew_quarters/courtroom)
"kS" = (
/obj/table/wood/auto,
/turf/simulated/floor/carpet/red/fancy/edge/sw,
/area/station/crew_quarters/courtroom)
"me" = (
/obj/machinery/light/incandescent,
/turf/simulated/floor/wood,
/area/station/crew_quarters/courtroom)
"ml" = (
/obj/table/wood/auto,
/turf/simulated/floor/carpet/green/fancy/edge/west,
/area/station/crew_quarters/courtroom)
"nK" = (
/obj/decoration/decorativeplant/plant3,
/turf/simulated/floor/wood,
/area/station/crew_quarters/courtroom)
"oj" = (
/obj/stool/chair/office/blue,
/turf/simulated/floor/carpet/blue/fancy/edge/nw,
/area/station/crew_quarters/courtroom)
"pb" = (
/obj/stool/chair/comfy{
	dir = 1
	},
/turf/simulated/floor/carpet/blue/fancy,
/area/station/crew_quarters/courtroom)
"pk" = (
/obj/table/wood/auto,
/obj/machinery/light/incandescent{
	dir = 1
	},
/turf/simulated/floor/carpet/green/fancy/edge/nw,
/area/station/crew_quarters/courtroom)
"ql" = (
/turf/simulated/floor/carpet/red/fancy/edge/sw,
/area/station/crew_quarters/courtroom)
"qM" = (
/obj/table/wood/auto/desk{
	icon_state = "6"
	},
/obj/item/clipboard/with_pen{
	pixel_y = 4
	},
/obj/item/paper_bin{
	pixel_y = 3
	},
/obj/item/pen/fancy{
	pixel_y = 4
	},
/turf/simulated/floor/carpet/blue/fancy/edge/nw,
/area/station/crew_quarters/courtroom)
"qN" = (
/obj/stool/chair/red{
	dir = 4
	},
/turf/simulated/floor/carpet/red/fancy/edge/ne,
/area/station/crew_quarters/courtroom)
"rD" = (
/obj/table/wood/auto/desk{
	icon_state = "10"
	},
/obj/item/paper/book/space_law,
/turf/simulated/floor/carpet/blue/fancy/edge/ne,
/area/station/crew_quarters/courtroom)
"rE" = (
/obj/item/storage/wall/office{
	dir = 4;
	pixel_x = -32;
	pixel_y = 0
	},
/turf/simulated/floor/wood,
/area/station/crew_quarters/courtroom)
"rN" = (
/obj/machinery/door_control{
	id = "jury_door";
	name = "Jury Conference Room Door Control";
	pixel_y = -26
	},
/turf/simulated/floor/wood,
/area/station/crew_quarters/courtroom)
"sD" = (
/obj/item/device/radio/intercom/security{
	dir = 4
	},
/turf/simulated/floor/carpet/red/fancy/edge/nw,
/area/station/crew_quarters/courtroom)
"uk" = (
/obj/table/wood/auto,
/turf/simulated/floor/carpet/green/fancy/edge/south,
/area/station/crew_quarters/courtroom)
"uK" = (
/obj/stool/chair/office/red,
/turf/simulated/floor/carpet/red/fancy/edge/nw,
/area/station/crew_quarters/courtroom)
"ve" = (
/obj/machinery/door/airlock/pyro/glass/security{
	dir = 4;
	req_access = null
	},
/obj/machinery/secscanner{
	dir = 4;
	pixel_x = 20
	},
/obj/access_spawn/security,
/obj/firedoor_spawn,
/turf/simulated/floor/wood,
/area/station/crew_quarters/courtroom)
"vv" = (
/obj/table/wood/auto,
/obj/item/clipboard/with_pen{
	pixel_y = 4
	},
/obj/item/paper_bin{
	pixel_y = 3
	},
/obj/item/pen{
	pixel_y = 4
	},
/turf/simulated/floor/carpet/blue/fancy/edge/sw,
/area/station/crew_quarters/courtroom)
"vH" = (
/turf/simulated/floor/carpet/blue/fancy/edge/sw,
/area/station/crew_quarters/courtroom)
"vN" = (
/obj/stool/chair/office{
	dir = 8
	},
/obj/blind_switch/area/east,
/turf/simulated/floor/carpet/green/fancy/edge/ne,
/area/station/crew_quarters/courtroom)
"wB" = (
/obj/table/wood/auto,
/turf/simulated/floor/carpet/blue/fancy/edge/se,
/area/station/crew_quarters/courtroom)
"wF" = (
/obj/table/wood/auto,
/turf/simulated/floor/carpet/green/fancy/edge/north,
/area/station/crew_quarters/courtroom)
"wW" = (
/obj/table/wood/auto,
/obj/item/folder,
/turf/simulated/floor/carpet/green/fancy,
/area/station/crew_quarters/courtroom)
"xm" = (
/obj/blind_switch/south,
/turf/simulated/floor/wood,
/area/station/crew_quarters/courtroom)
"xB" = (
/obj/stool/chair/office{
	dir = 8
	},
/turf/simulated/floor/carpet/green/fancy/edge/east,
/area/station/crew_quarters/courtroom)
"ya" = (
/obj/wingrille_spawn/auto,
/turf/simulated/floor/plating,
/area/station/crew_quarters/courtroom)
"yh" = (
/obj/stool/chair/office/blue,
/turf/simulated/floor/carpet/blue/fancy/edge/ne,
/area/station/crew_quarters/courtroom)
"yR" = (
/obj/machinery/disposal/small/east,
/turf/simulated/floor/wood,
/area/station/crew_quarters/courtroom)
"Bb" = (
/obj/stool/chair/office{
	dir = 8
	},
/obj/machinery/light/incandescent{
	dir = 4
	},
/turf/simulated/floor/carpet/green/fancy/edge/east,
/area/station/crew_quarters/courtroom)
"CP" = (
/obj/machinery/secscanner{
	pixel_y = -9
	},
/obj/machinery/door/airlock/pyro/security/alt,
/obj/access_spawn/security,
/obj/firedoor_spawn,
/turf/simulated/floor/wood,
/area/station/crew_quarters/courtroom)
"DU" = (
/obj/table/wood/auto,
/obj/item/clipboard/with_pen{
	pixel_y = 4
	},
/obj/item/paper_bin{
	pixel_y = 3
	},
/obj/item/pen{
	pixel_y = 4
	},
/turf/simulated/floor/carpet/red/fancy/edge/sw,
/area/station/crew_quarters/courtroom)
"Gm" = (
/obj/table/wood/auto/desk{
	icon_state = "1"
	},
/obj/item/clothing/suit/judgerobe,
/obj/item/clothing/head/powdered_wig{
	pixel_y = 11
	},
/turf/simulated/floor/carpet/blue/fancy/edge/west,
/area/station/crew_quarters/courtroom)
"Gx" = (
/obj/stool/chair/office{
	dir = 8
	},
/obj/machinery/light/incandescent{
	dir = 4
	},
/turf/simulated/floor/carpet/green/fancy/edge/se,
/area/station/crew_quarters/courtroom)
"GO" = (
/obj/stool/chair/office{
	dir = 4
	},
/obj/item/device/radio/intercom/security{
	dir = 4
	},
/turf/simulated/floor/carpet/green/fancy/edge/sw,
/area/station/crew_quarters/courtroom)
"HR" = (
/obj/item/storage/wall/office{
	dir = 8;
	pixel_x = 32;
	pixel_y = 0
	},
/turf/simulated/floor/wood,
/area/station/crew_quarters/courtroom)
"Jp" = (
/obj/stool/chair/office{
	dir = 8
	},
/obj/decoration/clock{
	pixel_x = 32
	},
/turf/simulated/floor/carpet/green/fancy/edge/east,
/area/station/crew_quarters/courtroom)
"JF" = (
/obj/stool/chair/office/red{
	dir = 8
	},
/obj/machinery/light/incandescent,
/turf/simulated/floor/carpet/red/fancy/edge/se,
/area/station/crew_quarters/courtroom)
"KJ" = (
/turf/simulated/wall/auto/supernorn,
/area/station/crew_quarters/courtroom)
"LM" = (
/turf/simulated/floor/carpet/blue/fancy/edge/se,
/area/station/crew_quarters/courtroom)
"Np" = (
/obj/table/reinforced,
/obj/item/clipboard/with_pen{
	pixel_y = 4
	},
/obj/item/paper_bin{
	pixel_y = 3
	},
/obj/item/pen{
	pixel_y = 4
	},
/obj/machinery/light/incandescent,
/turf/simulated/floor/carpet/red/fancy/edge/se,
/area/station/crew_quarters/courtroom)
"NV" = (
/obj/machinery/camera/television{
	name = "camera - courtroom"
	},
/turf/simulated/floor/wood,
/area/station/crew_quarters/courtroom)
"Oq" = (
/obj/machinery/light/incandescent{
	dir = 1
	},
/turf/simulated/floor/wood,
/area/station/crew_quarters/courtroom)
"Ov" = (
/obj/loudspeaker,
/turf/simulated/floor/wood,
/area/station/crew_quarters/courtroom)
"OF" = (
/obj/machinery/door/airlock/pyro/security/alt{
	dir = 4;
	id = "jury_door"
	},
/obj/access_spawn/security,
/obj/firedoor_spawn,
/turf/simulated/floor/wood,
/area/station/crew_quarters/courtroom)
"Pz" = (
/obj/firedoor_spawn,
/obj/machinery/door/airlock/pyro/security/alt,
/obj/access_spawn/security,
/turf/simulated/floor/wood,
/area/station/crew_quarters/courtroom)
"PK" = (
/obj/table/wood/auto/desk{
	icon_state = "1"
	},
/turf/simulated/floor/carpet/blue/fancy/edge/east,
/area/station/crew_quarters/courtroom)
"PS" = (
/obj/stool/chair/office,
/obj/item/device/radio/intercom/security{
	dir = 8
	},
/turf/simulated/floor/wood,
/area/station/crew_quarters/courtroom)
"PU" = (
/obj/item/device/radio/intercom/security{
	dir = 1
	},
/turf/simulated/floor/wood,
/area/station/crew_quarters/courtroom)
"Qq" = (
/obj/table/wood/auto,
/obj/machinery/computer3/generic/personal/personel_alt{
	pixel_y = 9
	},
/turf/simulated/floor/carpet/red/fancy/edge/nw,
/area/station/crew_quarters/courtroom)
"Sr" = (
/turf/space,
/area/space)
"Tj" = (
/obj/table/wood/auto/desk{
	icon_state = "12"
	},
/obj/item/toy/judge_block{
	pixel_y = 4
	},
/obj/item/toy/judge_gavel{
	pixel_x = -5;
	pixel_y = 3
	},
/turf/simulated/floor/carpet/blue/fancy/edge/north,
/area/station/crew_quarters/courtroom)
"Tk" = (
/obj/table/wood/auto,
/obj/item/clipboard/with_pen{
	pixel_y = 4
	},
/obj/item/paper_bin{
	pixel_y = 3
	},
/obj/item/pen{
	pixel_y = 4
	},
/turf/simulated/floor/carpet/green/fancy,
/area/station/crew_quarters/courtroom)
"Uj" = (
/obj/machinery/door/airlock/pyro/glass/security{
	req_access = null
	},
/obj/machinery/secscanner{
	pixel_y = -9
	},
/obj/firedoor_spawn,
/turf/simulated/floor/wood,
/area/station/crew_quarters/courtroom)
"US" = (
/obj/table/wood/auto,
/obj/item/clipboard/with_pen{
	pixel_y = 4
	},
/obj/item/paper_bin{
	pixel_y = 3
	},
/obj/item/pen{
	pixel_y = 4
	},
/turf/simulated/floor/carpet/green/fancy/edge/sw,
/area/station/crew_quarters/courtroom)
"UX" = (
/obj/table/wood/auto,
/obj/item/device/microphone{
	pixel_y = 5
	},
/turf/simulated/floor/wood,
/area/station/crew_quarters/courtroom)
"Wv" = (
/obj/stool/chair/office/red,
/turf/simulated/floor/carpet/red/fancy/edge/ne,
/area/station/crew_quarters/courtroom)
"XR" = (
/obj/machinery/disposal/small/south,
/turf/simulated/floor/wood,
/area/station/crew_quarters/courtroom)
"YR" = (
/obj/table/wood/auto,
/obj/item/folder,
/turf/simulated/floor/carpet/green/fancy/edge/west,
/area/station/crew_quarters/courtroom)

(1,1,1) = {"
KJ
KJ
KJ
KJ
KJ
KJ
KJ
KJ
KJ
ve
KJ
Sr
Sr
Sr
"}
(2,1,1) = {"
ya
jE
fg
fl
rE
gq
cl
ya
sD
ql
KJ
Sr
Sr
Sr
"}
(3,1,1) = {"
ya
fg
fg
fl
oj
vv
cl
ya
qN
Np
KJ
KJ
KJ
KJ
"}
(4,1,1) = {"
ya
Oq
fg
fl
yh
wB
cl
ya
ya
ya
KJ
fP
fP
KJ
"}
(5,1,1) = {"
Uj
cl
cl
CP
cl
cl
cl
gq
cl
cl
gq
cl
cl
Pz
"}
(6,1,1) = {"
Uj
cl
cl
CP
cl
cl
cl
Ov
cl
qM
Gm
vH
me
KJ
"}
(7,1,1) = {"
ya
Oq
fg
fl
uK
kS
fg
UX
cl
Tj
pb
ip
xm
KJ
"}
(8,1,1) = {"
ya
fg
fg
fl
Wv
cK
cl
NV
cl
rD
PK
LM
XR
KJ
"}
(9,1,1) = {"
ya
PS
dc
fl
cl
cl
cl
cl
cl
cl
cl
cl
PU
KJ
"}
(10,1,1) = {"
KJ
KJ
KJ
KJ
pk
ml
ml
ml
YR
US
cl
Qq
DU
KJ
"}
(11,1,1) = {"
Sr
Sr
Sr
KJ
eF
kn
Bb
xB
xB
Gx
cl
bI
JF
KJ
"}
(12,1,1) = {"
Sr
Sr
Sr
KJ
KJ
KJ
KJ
KJ
KJ
KJ
OF
KJ
KJ
KJ
"}
(13,1,1) = {"
Sr
Sr
Sr
Sr
Sr
fl
in
iy
GO
yR
rN
KJ
Sr
Sr
"}
(14,1,1) = {"
Sr
Sr
Sr
Sr
Sr
fl
wF
Tk
uk
cl
me
KJ
Sr
Sr
"}
(15,1,1) = {"
Sr
Sr
Sr
Sr
Sr
fl
wF
wW
uk
cl
nK
KJ
Sr
Sr
"}
(16,1,1) = {"
Sr
Sr
Sr
Sr
Sr
fl
vN
Jp
Gx
HR
bB
KJ
Sr
Sr
"}
(17,1,1) = {"
Sr
Sr
Sr
Sr
Sr
KJ
KJ
KJ
KJ
KJ
KJ
KJ
Sr
Sr
"}
