//MAP CONVERTED BY dmm2tgm.py THIS HEADER COMMENT PREVENTS RECONVERSION, DO NOT REMOVE
"am" = (
/obj/machinery/secscanner{
	pixel_y = -9
	},
/obj/machinery/door/airlock/pyro/security/alt,
/obj/access_spawn/security,
/obj/firedoor_spawn,
/turf/simulated/floor/wood,
/area/station/crew_quarters/courtroom)
"aZ" = (
/obj/table/wood/auto,
/obj/item/audio_tape,
/turf/simulated/floor/carpet/green/fancy/edge/south,
/area/station/crew_quarters/courtroom{
	name = "Jury Conference Room"
	})
"cI" = (
/obj/item/clipboard/with_pen{
	pixel_y = 4
	},
/obj/item/paper_bin{
	pixel_y = 3
	},
/obj/item/pen{
	pixel_y = 4
	},
/obj/table/wood{
	icon_state = "4"
	},
/turf/simulated/floor/carpet/blue/fancy/edge/west,
/area/station/crew_quarters/courtroom)
"ee" = (
/obj/machinery/light/incandescent,
/turf/simulated/floor/wood,
/area/station/crew_quarters/courtroom{
	name = "Jury Conference Room"
	})
"eY" = (
/obj/machinery/light/incandescent,
/obj/stool/chair/office/red{
	dir = 1
	},
/turf/simulated/floor/carpet/red/fancy/edge/south,
/area/station/crew_quarters/courtroom)
"fn" = (
/obj/item/clipboard/with_pen{
	pixel_y = 4
	},
/obj/item/paper_bin{
	pixel_y = 3
	},
/obj/item/pen{
	pixel_y = 4
	},
/obj/table/wood{
	icon_state = "1"
	},
/turf/simulated/floor/carpet/green/fancy/edge/sw,
/area/station/crew_quarters/courtroom)
"fo" = (
/turf/simulated/floor/carpet/blue/fancy/edge/se,
/area/station/crew_quarters/courtroom)
"gy" = (
/obj/machinery/light/incandescent{
	dir = 8
	},
/turf/simulated/floor/wood,
/area/station/crew_quarters/courtroom)
"gQ" = (
/obj/table/wood{
	icon_state = "3"
	},
/turf/simulated/floor/carpet/green/fancy/edge/west,
/area/station/crew_quarters/courtroom)
"hE" = (
/obj/firedoor_spawn,
/obj/machinery/door/airlock/pyro/security/alt,
/obj/access_spawn/security,
/obj/machinery/secscanner{
	pixel_y = 9
	},
/turf/simulated/floor/wood,
/area/station/crew_quarters/courtroom)
"hV" = (
/obj/storage/closet/office,
/turf/simulated/floor/wood,
/area/station/crew_quarters/courtroom)
"jl" = (
/obj/table/wood{
	icon_state = "1"
	},
/turf/simulated/floor/carpet/green/fancy/edge/west,
/area/station/crew_quarters/courtroom)
"kD" = (
/obj/table/wood/auto/desk{
	icon_state = "10"
	},
/obj/item/paper/book/space_law,
/turf/simulated/floor/carpet/blue/fancy/edge/ne,
/area/station/crew_quarters/courtroom)
"kP" = (
/turf/simulated/floor/carpet/blue/fancy/edge,
/area/station/crew_quarters/courtroom)
"ln" = (
/obj/loudspeaker,
/turf/simulated/floor/wood,
/area/station/crew_quarters/courtroom)
"ls" = (
/obj/wingrille_spawn/auto,
/turf/simulated/floor/plating,
/area/station/crew_quarters/courtroom{
	name = "Courtroom Public Gallery"
	})
"lH" = (
/obj/machinery/disposal/small/east,
/turf/simulated/floor/wood,
/area/station/crew_quarters/courtroom{
	name = "Jury Conference Room"
	})
"lO" = (
/obj/stool/chair/office{
	dir = 4
	},
/turf/simulated/floor/carpet/green/fancy/edge/se,
/area/station/crew_quarters/courtroom{
	name = "Courtroom Public Gallery"
	})
"mv" = (
/obj/machinery/door/airlock/pyro/glass/security{
	dir = 4;
	req_access = null
	},
/obj/machinery/secscanner{
	dir = 4;
	pixel_x = 20
	},
/obj/access_spawn/security,
/obj/firedoor_spawn,
/turf/simulated/floor/wood,
/area/station/crew_quarters/courtroom)
"mD" = (
/obj/stool/chair/office/red,
/turf/simulated/floor/carpet/red/fancy/edge/ne,
/area/station/crew_quarters/courtroom)
"nE" = (
/obj/wingrille_spawn/auto,
/obj/window_blinds/cog2,
/turf/simulated/floor/plating,
/area/station/crew_quarters/courtroom{
	name = "Jury Conference Room"
	})
"nS" = (
/obj/stool/chair/office{
	dir = 4
	},
/turf/simulated/floor/carpet/green/fancy/edge/nw,
/area/station/crew_quarters/courtroom{
	name = "Jury Conference Room"
	})
"ob" = (
/obj/stool/chair/red{
	dir = 4
	},
/turf/simulated/floor/carpet/red/fancy/edge/ne,
/area/station/crew_quarters/courtroom)
"pE" = (
/turf/simulated/wall/auto/supernorn,
/area/station/crew_quarters/courtroom{
	name = "Courtroom Public Gallery"
	})
"pS" = (
/turf/simulated/floor/carpet/red/fancy/edge/se,
/area/station/crew_quarters/courtroom)
"qH" = (
/obj/table/reinforced,
/obj/item/clipboard/with_pen{
	pixel_y = 4
	},
/obj/item/paper_bin{
	pixel_y = 3
	},
/obj/item/pen{
	pixel_y = 4
	},
/obj/machinery/light/incandescent,
/turf/simulated/floor/carpet/red/fancy/edge/se,
/area/station/crew_quarters/courtroom)
"rj" = (
/turf/simulated/wall/auto/supernorn,
/area/station/crew_quarters/courtroom)
"rm" = (
/obj/machinery/light/incandescent{
	dir = 8
	},
/turf/simulated/floor/carpet/green/fancy/edge/west,
/area/station/crew_quarters/courtroom{
	name = "Courtroom Public Gallery"
	})
"rz" = (
/turf/simulated/floor/carpet/red/fancy/edge/sw,
/area/station/crew_quarters/courtroom)
"rL" = (
/obj/stool/chair/office{
	dir = 8
	},
/turf/simulated/floor/carpet/green/fancy/edge/east,
/area/station/crew_quarters/courtroom)
"rS" = (
/obj/stool/chair/office{
	dir = 8
	},
/obj/machinery/light/incandescent{
	dir = 4
	},
/turf/simulated/floor/carpet/green/fancy/edge/se,
/area/station/crew_quarters/courtroom{
	name = "Jury Conference Room"
	})
"sX" = (
/obj/machinery/door_control{
	id = "jury_door";
	name = "Jury Conference Room Door Control";
	pixel_y = -26
	},
/turf/simulated/floor/wood,
/area/station/crew_quarters/courtroom{
	name = "Jury Conference Room"
	})
"ui" = (
/obj/stool/chair/office{
	dir = 8
	},
/obj/decoration/clock{
	pixel_x = 32
	},
/turf/simulated/floor/carpet/green/fancy/edge/east,
/area/station/crew_quarters/courtroom{
	name = "Jury Conference Room"
	})
"uo" = (
/obj/table/wood/auto,
/turf/simulated/floor/carpet/green/fancy/edge/north,
/area/station/crew_quarters/courtroom{
	name = "Jury Conference Room"
	})
"uW" = (
/obj/stool/chair/office{
	dir = 4
	},
/turf/simulated/floor/carpet/green/fancy/edge/ne,
/area/station/crew_quarters/courtroom{
	name = "Courtroom Public Gallery"
	})
"vN" = (
/obj/item/storage/wall/office{
	dir = 8;
	pixel_x = 32;
	pixel_y = 0
	},
/turf/simulated/floor/wood,
/area/station/crew_quarters/courtroom{
	name = "Jury Conference Room"
	})
"xz" = (
/obj/machinery/door/airlock/pyro/glass/security{
	req_access = null
	},
/obj/firedoor_spawn,
/obj/machinery/secscanner{
	pixel_y = -9
	},
/turf/simulated/floor/wood,
/area/station/crew_quarters/courtroom{
	name = "Courtroom Public Gallery"
	})
"xE" = (
/turf/simulated/wall/auto/supernorn,
/area/station/crew_quarters/courtroom{
	name = "Jury Conference Room"
	})
"yh" = (
/obj/stool/chair/office{
	dir = 4
	},
/obj/item/device/radio/intercom/security{
	dir = 4
	},
/turf/simulated/floor/carpet/green/fancy/edge/sw,
/area/station/crew_quarters/courtroom{
	name = "Jury Conference Room"
	})
"yB" = (
/obj/machinery/light/incandescent{
	dir = 1
	},
/obj/table/wood{
	icon_state = "3"
	},
/turf/simulated/floor/carpet/green/fancy/edge/nw,
/area/station/crew_quarters/courtroom)
"yS" = (
/turf/simulated/floor/wood,
/area/station/crew_quarters/courtroom)
"yT" = (
/obj/decoration/decorativeplant/plant3,
/turf/simulated/floor/wood,
/area/station/crew_quarters/courtroom{
	name = "Jury Conference Room"
	})
"zD" = (
/turf/simulated/floor/carpet/green/fancy/edge/sw,
/area/station/crew_quarters/courtroom)
"Af" = (
/turf/space,
/area/space)
"Ak" = (
/obj/table/wood{
	icon_state = "8"
	},
/turf/simulated/floor/carpet/green/fancy/edge/ne,
/area/station/crew_quarters/courtroom)
"AJ" = (
/turf/simulated/floor/wood,
/area/station/crew_quarters/courtroom{
	name = "Jury Conference Room"
	})
"Dd" = (
/obj/machinery/computer3/generic/personal/personel_alt{
	pixel_y = 9
	},
/obj/table/wood{
	icon_state = "8"
	},
/turf/simulated/floor/carpet/red/fancy/edge/north,
/area/station/crew_quarters/courtroom)
"DT" = (
/obj/stool/chair/office{
	dir = 4
	},
/turf/simulated/floor/carpet/green/fancy/edge/east,
/area/station/crew_quarters/courtroom{
	name = "Courtroom Public Gallery"
	})
"Ez" = (
/obj/machinery/light/small/floor,
/turf/simulated/floor/wood,
/area/station/crew_quarters/courtroom)
"EQ" = (
/obj/reagent_dispensers/watertank/fountain,
/turf/simulated/floor/wood,
/area/station/crew_quarters/courtroom{
	name = "Jury Conference Room"
	})
"Ff" = (
/turf/simulated/floor/carpet/red/fancy/edge/ne,
/area/station/crew_quarters/courtroom)
"Fm" = (
/obj/stool/chair/office{
	dir = 4
	},
/turf/simulated/floor/carpet/green/fancy/edge/sw,
/area/station/crew_quarters/courtroom{
	name = "Courtroom Public Gallery"
	})
"FC" = (
/obj/storage/closet/law,
/obj/machinery/light/incandescent,
/obj/item/audio_tape,
/obj/item/audio_tape,
/turf/simulated/floor/wood,
/area/station/crew_quarters/courtroom)
"GV" = (
/obj/stool/chair/office{
	dir = 8
	},
/obj/decoration/clock{
	pixel_y = 32
	},
/turf/simulated/floor/carpet/green/fancy/edge/ne,
/area/station/crew_quarters/courtroom)
"Ha" = (
/obj/table/wood/auto,
/obj/item/folder,
/turf/simulated/floor/carpet/green/fancy,
/area/station/crew_quarters/courtroom{
	name = "Jury Conference Room"
	})
"Hj" = (
/obj/item/clipboard/with_pen{
	pixel_y = 4
	},
/obj/item/paper_bin{
	pixel_y = 3
	},
/obj/item/pen{
	pixel_y = 4
	},
/obj/table/wood{
	icon_state = "8"
	},
/turf/simulated/floor/carpet/red/fancy/edge/east,
/area/station/crew_quarters/courtroom)
"Hn" = (
/obj/stool/chair/office{
	dir = 4
	},
/obj/machinery/light/incandescent{
	dir = 8
	},
/turf/simulated/floor/carpet/green/fancy/edge/west,
/area/station/crew_quarters/courtroom{
	name = "Jury Conference Room"
	})
"HC" = (
/turf/simulated/floor/carpet/blue/fancy/edge/sw,
/area/station/crew_quarters/courtroom)
"HZ" = (
/obj/table/wood{
	icon_state = "1"
	},
/turf/simulated/floor/carpet/red/fancy/edge/sw,
/area/station/crew_quarters/courtroom)
"IH" = (
/obj/item/clipboard/with_pen{
	pixel_y = 4
	},
/obj/item/paper_bin{
	pixel_y = 3
	},
/obj/item/pen{
	pixel_y = 4
	},
/obj/table/wood{
	icon_state = "6"
	},
/turf/simulated/floor/carpet/red/fancy/edge/nw,
/area/station/crew_quarters/courtroom)
"IS" = (
/obj/table/wood/auto,
/obj/item/device/audio_log/radioship/large,
/turf/simulated/floor/carpet/green/fancy/edge/south,
/area/station/crew_quarters/courtroom{
	name = "Jury Conference Room"
	})
"Jh" = (
/obj/table/wood/auto,
/obj/item/clipboard/with_pen{
	pixel_y = 4
	},
/obj/item/paper_bin{
	pixel_y = 3
	},
/obj/item/pen{
	pixel_y = 4
	},
/turf/simulated/floor/carpet/green/fancy,
/area/station/crew_quarters/courtroom{
	name = "Jury Conference Room"
	})
"JY" = (
/obj/machinery/door/airlock/pyro/security/alt{
	dir = 4;
	id = "jury_door"
	},
/obj/access_spawn/security,
/obj/firedoor_spawn,
/obj/machinery/secscanner{
	dir = 4;
	pixel_x = -20
	},
/turf/simulated/floor/wood,
/area/station/crew_quarters/courtroom{
	name = "Jury Conference Room"
	})
"Mq" = (
/obj/table/wood/auto/desk{
	icon_state = "12"
	},
/obj/item/toy/judge_block{
	pixel_y = 4
	},
/obj/item/toy/judge_gavel{
	pixel_x = -5;
	pixel_y = 3
	},
/turf/simulated/floor/carpet/blue/fancy/edge/north,
/area/station/crew_quarters/courtroom)
"MH" = (
/turf/simulated/floor/carpet/green/fancy/edge/se,
/area/station/crew_quarters/courtroom)
"Nb" = (
/obj/item/device/radio/intercom/security{
	dir = 4
	},
/turf/simulated/floor/carpet/red/fancy/edge/nw,
/area/station/crew_quarters/courtroom)
"Oo" = (
/obj/stool/chair/office/blue,
/turf/simulated/floor/carpet/blue/fancy/edge/ne,
/area/station/crew_quarters/courtroom)
"Oy" = (
/obj/machinery/light/incandescent,
/turf/simulated/floor/wood,
/area/station/crew_quarters/courtroom)
"PH" = (
/obj/stool/chair/office{
	dir = 8
	},
/obj/item/device/radio/intercom/security{
	dir = 8
	},
/turf/simulated/floor/carpet/green/fancy/edge/east,
/area/station/crew_quarters/courtroom)
"PM" = (
/obj/machinery/disposal/small/south,
/turf/simulated/floor/wood,
/area/station/crew_quarters/courtroom)
"QM" = (
/obj/table/wood/auto/desk{
	icon_state = "1"
	},
/obj/item/clothing/suit/judgerobe,
/obj/item/clothing/head/powdered_wig{
	pixel_y = 11
	},
/turf/simulated/floor/carpet/blue/fancy/edge/west,
/area/station/crew_quarters/courtroom)
"Ro" = (
/obj/stool/chair/office/red,
/obj/machinery/light/incandescent{
	dir = 1
	},
/turf/simulated/floor/carpet/red/fancy/edge/nw,
/area/station/crew_quarters/courtroom)
"Ry" = (
/obj/item/device/microphone{
	pixel_y = 5
	},
/obj/table/wood{
	icon_state = "6"
	},
/turf/simulated/floor/carpet/green/fancy/edge/nw,
/area/station/crew_quarters/courtroom)
"RU" = (
/obj/stool/chair/office/blue,
/turf/simulated/floor/carpet/blue/fancy/edge/nw,
/area/station/crew_quarters/courtroom)
"Sv" = (
/obj/stool/chair/office{
	dir = 4
	},
/turf/simulated/floor/carpet/green/fancy/edge/west,
/area/station/crew_quarters/courtroom{
	name = "Courtroom Public Gallery"
	})
"TF" = (
/obj/stool/chair/comfy{
	dir = 1
	},
/turf/simulated/floor/carpet/blue/fancy,
/area/station/crew_quarters/courtroom)
"Uv" = (
/obj/item/folder,
/obj/table/wood{
	icon_state = "3"
	},
/turf/simulated/floor/carpet/green/fancy/edge/west,
/area/station/crew_quarters/courtroom)
"Uz" = (
/obj/stool/chair/office{
	dir = 8
	},
/obj/machinery/light/incandescent{
	dir = 4
	},
/turf/simulated/floor/carpet/green/fancy/edge/east,
/area/station/crew_quarters/courtroom)
"UH" = (
/obj/storage/closet/law,
/obj/item/audio_tape,
/obj/item/audio_tape,
/turf/simulated/floor/wood,
/area/station/crew_quarters/courtroom)
"UI" = (
/obj/item/device/radio/intercom/security{
	dir = 4
	},
/turf/simulated/floor/carpet/green/fancy/edge/west,
/area/station/crew_quarters/courtroom{
	name = "Courtroom Public Gallery"
	})
"Vz" = (
/obj/table/wood/auto/desk{
	icon_state = "6"
	},
/obj/item/clipboard/with_pen{
	pixel_y = 4
	},
/obj/item/paper_bin{
	pixel_y = 3
	},
/obj/item/pen/fancy{
	pixel_y = 4
	},
/turf/simulated/floor/carpet/blue/fancy/edge/nw,
/area/station/crew_quarters/courtroom)
"Wm" = (
/obj/table/wood{
	icon_state = "4"
	},
/turf/simulated/floor/carpet/red/fancy/edge/west,
/area/station/crew_quarters/courtroom)
"WX" = (
/obj/stool/chair/office{
	dir = 8
	},
/obj/blind_switch/area/east,
/turf/simulated/floor/carpet/green/fancy/edge/ne,
/area/station/crew_quarters/courtroom{
	name = "Jury Conference Room"
	})
"Xw" = (
/obj/machinery/camera/television{
	dir = 8;
	name = "camera - courtroom"
	},
/turf/simulated/floor/wood,
/area/station/crew_quarters/courtroom)
"XD" = (
/obj/wingrille_spawn/auto,
/turf/simulated/floor/plating,
/area/station/crew_quarters/courtroom)
"XE" = (
/obj/table/wood{
	icon_state = "8"
	},
/turf/simulated/floor/carpet/blue/fancy/edge/east,
/area/station/crew_quarters/courtroom)
"Yg" = (
/obj/stool/chair/office{
	dir = 8
	},
/obj/machinery/light/incandescent{
	dir = 4
	},
/turf/simulated/floor/carpet/green/fancy/edge/se,
/area/station/crew_quarters/courtroom)
"Yh" = (
/obj/table/wood/auto/desk{
	icon_state = "1"
	},
/obj/item/device/audio_log/radioship/large,
/turf/simulated/floor/carpet/blue/fancy/edge/east,
/area/station/crew_quarters/courtroom)
"YP" = (
/obj/stool/chair/office{
	dir = 4
	},
/turf/simulated/floor/carpet/green/fancy/edge/nw,
/area/station/crew_quarters/courtroom{
	name = "Courtroom Public Gallery"
	})

(1,1,1) = {"
pE
pE
pE
pE
pE
pE
pE
rj
rj
mv
rj
Af
"}
(2,1,1) = {"
xz
YP
Sv
UI
rm
Sv
Fm
XD
Nb
rz
rj
Af
"}
(3,1,1) = {"
xz
uW
DT
DT
DT
DT
lO
XD
ob
qH
rj
Af
"}
(4,1,1) = {"
pE
ls
ls
ls
ls
ls
ls
XD
XD
XD
rj
Af
"}
(5,1,1) = {"
XD
yS
gy
yS
yS
yS
gy
yS
yS
yS
hE
Af
"}
(6,1,1) = {"
XD
RU
cI
HC
yS
Vz
QM
HC
yS
Oy
rj
Af
"}
(7,1,1) = {"
XD
Oo
XE
fo
yS
Mq
TF
kP
yS
yS
rj
Af
"}
(8,1,1) = {"
am
yS
yS
Ez
yS
kD
Yh
fo
yS
PM
rj
rj
"}
(9,1,1) = {"
am
yS
yS
yS
yS
yS
Ez
yS
yS
IH
HZ
rj
"}
(10,1,1) = {"
XD
Ro
Wm
rz
Xw
Ry
jl
zD
yS
Dd
eY
rj
"}
(11,1,1) = {"
XD
mD
Hj
pS
ln
Ak
rL
MH
yS
Ff
pS
rj
"}
(12,1,1) = {"
XD
yS
yS
yS
yS
yS
yS
yS
hV
rj
rj
rj
"}
(13,1,1) = {"
rj
yB
gQ
gQ
gQ
Uv
fn
yS
FC
rj
Af
Af
"}
(14,1,1) = {"
rj
GV
PH
Uz
rL
rL
Yg
yS
UH
rj
Af
Af
"}
(15,1,1) = {"
rj
rj
rj
rj
rj
rj
rj
JY
rj
rj
Af
Af
"}
(16,1,1) = {"
Af
Af
nE
nS
Hn
yh
lH
sX
xE
Af
Af
Af
"}
(17,1,1) = {"
Af
Af
nE
uo
Jh
IS
AJ
ee
xE
Af
Af
Af
"}
(18,1,1) = {"
Af
Af
nE
uo
Ha
aZ
AJ
yT
xE
Af
Af
Af
"}
(19,1,1) = {"
Af
Af
nE
WX
ui
rS
vN
EQ
xE
Af
Af
Af
"}
(20,1,1) = {"
Af
Af
xE
xE
xE
xE
xE
xE
xE
Af
Af
Af
"}
