//MAP CONVERTED BY dmm2tgm.py THIS HEADER COMMENT PREVENTS RECONVERSION, DO NOT REMOVE
"an" = (
/obj/table/wood{
	icon_state = "8"
	},
/turf/simulated/floor/carpet/blue/fancy/edge/east,
/area/station/crew_quarters/courtroom)
"ch" = (
/obj/decoration/decorativeplant/plant3,
/turf/simulated/floor/wood,
/area/station/crew_quarters/courtroom{
	name = "Jury Conference Room"
	})
"cy" = (
/obj/stool/chair/office/red,
/obj/machinery/light/incandescent{
	dir = 1
	},
/turf/simulated/floor/carpet/red/fancy/edge/nw,
/area/station/crew_quarters/courtroom)
"cB" = (
/obj/table/wood{
	icon_state = "4"
	},
/turf/simulated/floor/carpet/red/fancy/edge/west,
/area/station/crew_quarters/courtroom)
"dH" = (
/obj/item/device/microphone{
	pixel_y = 5
	},
/obj/table/wood{
	icon_state = "6"
	},
/turf/simulated/floor/carpet/green/fancy/edge/nw,
/area/station/crew_quarters/courtroom)
"eI" = (
/obj/machinery/light/small/floor,
/turf/simulated/floor/wood,
/area/station/crew_quarters/courtroom)
"fe" = (
/obj/table/wood{
	icon_state = "8"
	},
/turf/simulated/floor/carpet/green/fancy/edge/ne,
/area/station/crew_quarters/courtroom)
"ff" = (
/obj/table/wood{
	icon_state = "1"
	},
/turf/simulated/floor/carpet/red/fancy/edge/sw,
/area/station/crew_quarters/courtroom)
"fl" = (
/obj/stool/chair/office{
	dir = 8
	},
/turf/simulated/floor/carpet/green/fancy/edge/east,
/area/station/crew_quarters/courtroom)
"fn" = (
/obj/machinery/door/airlock/pyro/security/alt{
	dir = 4;
	id = "jury_door"
	},
/obj/access_spawn/security,
/obj/firedoor_spawn,
/obj/machinery/secscanner{
	dir = 4;
	pixel_x = -20
	},
/turf/simulated/floor/wood,
/area/station/crew_quarters/courtroom{
	name = "Jury Conference Room"
	})
"fX" = (
/turf/simulated/floor/carpet/red/fancy/edge/sw,
/area/station/crew_quarters/courtroom)
"gl" = (
/obj/machinery/disposal/small/east,
/turf/simulated/floor/wood,
/area/station/crew_quarters/courtroom{
	name = "Jury Conference Room"
	})
"gw" = (
/turf/simulated/floor/carpet/green/fancy/edge/se,
/area/station/crew_quarters/courtroom)
"iw" = (
/obj/stool/chair/office{
	dir = 4
	},
/turf/simulated/floor/carpet/green/fancy/edge/east,
/area/station/crew_quarters/courtroom{
	name = "Courtroom Public Gallery"
	})
"iE" = (
/obj/table/wood{
	icon_state = "3"
	},
/turf/simulated/floor/carpet/green/fancy/edge/west,
/area/station/crew_quarters/courtroom)
"iO" = (
/obj/machinery/secscanner{
	pixel_y = -9
	},
/obj/machinery/door/airlock/pyro/security/alt,
/obj/firedoor_spawn,
/turf/simulated/floor/wood,
/area/station/crew_quarters/courtroom)
"jx" = (
/obj/item/clipboard/with_pen{
	pixel_y = 4
	},
/obj/item/paper_bin{
	pixel_y = 3
	},
/obj/item/pen{
	pixel_y = 4
	},
/obj/table/wood{
	icon_state = "4"
	},
/turf/simulated/floor/carpet/blue/fancy/edge/west,
/area/station/crew_quarters/courtroom)
"jG" = (
/obj/item/folder,
/obj/table/wood{
	icon_state = "3"
	},
/turf/simulated/floor/carpet/green/fancy/edge/west,
/area/station/crew_quarters/courtroom)
"kh" = (
/obj/stool/chair/office{
	dir = 4
	},
/turf/simulated/floor/carpet/green/fancy/edge/ne,
/area/station/crew_quarters/courtroom{
	name = "Courtroom Public Gallery"
	})
"kO" = (
/turf/simulated/floor/wood,
/area/station/crew_quarters/courtroom{
	name = "Jury Conference Room"
	})
"lh" = (
/obj/stool/chair/office/red,
/turf/simulated/floor/carpet/red/fancy/edge/ne,
/area/station/crew_quarters/courtroom)
"lE" = (
/obj/wingrille_spawn/auto,
/turf/simulated/floor/plating,
/area/station/crew_quarters/courtroom)
"mS" = (
/obj/machinery/light/incandescent,
/obj/stool/chair/office/red{
	dir = 1
	},
/turf/simulated/floor/carpet/red/fancy/edge/south,
/area/station/crew_quarters/courtroom)
"pg" = (
/obj/machinery/computer3/generic/personal/personel_alt{
	pixel_y = 9
	},
/obj/table/wood{
	icon_state = "8"
	},
/turf/simulated/floor/carpet/red/fancy/edge/north,
/area/station/crew_quarters/courtroom)
"pL" = (
/turf/simulated/floor/wood,
/area/station/crew_quarters/courtroom)
"pU" = (
/obj/machinery/light/incandescent{
	dir = 8
	},
/turf/simulated/floor/carpet/green/fancy/edge/west,
/area/station/crew_quarters/courtroom{
	name = "Courtroom Public Gallery"
	})
"qB" = (
/obj/wingrille_spawn/auto,
/turf/simulated/floor/plating,
/area/station/crew_quarters/courtroom{
	name = "Courtroom Public Gallery"
	})
"rc" = (
/obj/table/wood/auto,
/obj/item/device/audio_log/radioship/large,
/turf/simulated/floor/carpet/green/fancy/edge/south,
/area/station/crew_quarters/courtroom{
	name = "Jury Conference Room"
	})
"rA" = (
/obj/machinery/light/incandescent,
/turf/simulated/floor/wood,
/area/station/crew_quarters/courtroom{
	name = "Jury Conference Room"
	})
"sy" = (
/obj/stool/chair/office{
	dir = 8
	},
/obj/machinery/light/incandescent{
	dir = 4
	},
/turf/simulated/floor/carpet/green/fancy/edge/se,
/area/station/crew_quarters/courtroom)
"sC" = (
/obj/machinery/door/airlock/pyro/glass/security{
	dir = 4;
	req_access = null
	},
/obj/machinery/secscanner{
	dir = 4;
	pixel_x = 20
	},
/obj/access_spawn/security,
/obj/firedoor_spawn,
/turf/simulated/floor/wood,
/area/station/crew_quarters/courtroom)
"tR" = (
/obj/stool/chair/office{
	dir = 4
	},
/turf/simulated/floor/carpet/green/fancy/edge/sw,
/area/station/crew_quarters/courtroom{
	name = "Courtroom Public Gallery"
	})
"ua" = (
/obj/storage/closet/law,
/obj/item/audio_tape,
/obj/item/audio_tape,
/turf/simulated/floor/wood,
/area/station/crew_quarters/courtroom)
"wA" = (
/obj/table/wood{
	icon_state = "1"
	},
/turf/simulated/floor/carpet/green/fancy/edge/west,
/area/station/crew_quarters/courtroom)
"wU" = (
/turf/simulated/wall/auto/supernorn,
/area/station/crew_quarters/courtroom)
"wW" = (
/obj/stool/chair/office{
	dir = 4
	},
/turf/simulated/floor/carpet/green/fancy/edge/west,
/area/station/crew_quarters/courtroom{
	name = "Courtroom Public Gallery"
	})
"xd" = (
/obj/item/clipboard/with_pen{
	pixel_y = 4
	},
/obj/item/paper_bin{
	pixel_y = 3
	},
/obj/item/pen{
	pixel_y = 4
	},
/obj/table/wood{
	icon_state = "6"
	},
/turf/simulated/floor/carpet/red/fancy/edge/nw,
/area/station/crew_quarters/courtroom)
"xE" = (
/obj/stool/chair/office{
	dir = 4
	},
/turf/simulated/floor/carpet/green/fancy/edge/se,
/area/station/crew_quarters/courtroom{
	name = "Courtroom Public Gallery"
	})
"xM" = (
/obj/machinery/camera/television{
	dir = 8;
	name = "camera - courtroom"
	},
/turf/simulated/floor/wood,
/area/station/crew_quarters/courtroom)
"yO" = (
/obj/stool/chair/office{
	dir = 8
	},
/obj/decoration/clock{
	pixel_y = 32
	},
/turf/simulated/floor/carpet/green/fancy/edge/ne,
/area/station/crew_quarters/courtroom)
"za" = (
/turf/simulated/wall/auto/supernorn,
/area/station/crew_quarters/courtroom{
	name = "Courtroom Public Gallery"
	})
"zl" = (
/obj/machinery/door/airlock/pyro/glass/security{
	req_access = null
	},
/obj/firedoor_spawn,
/obj/machinery/secscanner{
	pixel_y = -9
	},
/turf/simulated/floor/wood,
/area/station/crew_quarters/courtroom{
	name = "Courtroom Public Gallery"
	})
"zC" = (
/obj/wingrille_spawn/auto,
/obj/window_blinds/cog2,
/turf/simulated/floor/plating,
/area/station/crew_quarters/courtroom{
	name = "Jury Conference Room"
	})
"Ab" = (
/turf/simulated/floor/carpet/red/fancy/edge/se,
/area/station/crew_quarters/courtroom)
"Bg" = (
/obj/machinery/light/incandescent{
	dir = 8
	},
/turf/simulated/floor/wood,
/area/station/crew_quarters/courtroom)
"BB" = (
/obj/table/wood/auto/desk{
	icon_state = "10"
	},
/obj/item/paper/book/space_law,
/turf/simulated/floor/carpet/blue/fancy/edge/ne,
/area/station/crew_quarters/courtroom)
"BQ" = (
/obj/machinery/door_control{
	id = "jury_door";
	name = "Jury Conference Room Door Control";
	pixel_y = -26
	},
/turf/simulated/floor/wood,
/area/station/crew_quarters/courtroom{
	name = "Jury Conference Room"
	})
"Cw" = (
/turf/simulated/floor/carpet/blue/fancy/edge,
/area/station/crew_quarters/courtroom)
"DJ" = (
/obj/stool/chair/office{
	dir = 4
	},
/turf/simulated/floor/carpet/green/fancy/edge/nw,
/area/station/crew_quarters/courtroom{
	name = "Jury Conference Room"
	})
"DK" = (
/obj/table/wood/auto,
/turf/simulated/floor/carpet/green/fancy/edge/north,
/area/station/crew_quarters/courtroom{
	name = "Jury Conference Room"
	})
"Fd" = (
/obj/stool/chair/office{
	dir = 8
	},
/obj/blind_switch/area/east,
/turf/simulated/floor/carpet/green/fancy/edge/ne,
/area/station/crew_quarters/courtroom{
	name = "Jury Conference Room"
	})
"FJ" = (
/turf/simulated/wall/auto/supernorn,
/area/station/crew_quarters/courtroom{
	name = "Jury Conference Room"
	})
"FN" = (
/obj/stool/chair/office{
	dir = 8
	},
/obj/item/device/radio/intercom/security{
	dir = 8
	},
/turf/simulated/floor/carpet/green/fancy/edge/east,
/area/station/crew_quarters/courtroom)
"Gy" = (
/obj/storage/closet/law,
/obj/machinery/light/incandescent,
/obj/item/audio_tape,
/obj/item/audio_tape,
/turf/simulated/floor/wood,
/area/station/crew_quarters/courtroom)
"Hm" = (
/turf/simulated/floor/carpet/green/fancy/edge/sw,
/area/station/crew_quarters/courtroom)
"HB" = (
/turf/simulated/floor/carpet/blue/fancy/edge/sw,
/area/station/crew_quarters/courtroom)
"Ik" = (
/obj/machinery/disposal/small/south,
/turf/simulated/floor/wood,
/area/station/crew_quarters/courtroom)
"JG" = (
/obj/item/device/radio/intercom/security{
	dir = 4
	},
/turf/simulated/floor/carpet/green/fancy/edge/west,
/area/station/crew_quarters/courtroom{
	name = "Courtroom Public Gallery"
	})
"JV" = (
/obj/stool/chair/office{
	dir = 4
	},
/turf/simulated/floor/carpet/green/fancy/edge/nw,
/area/station/crew_quarters/courtroom{
	name = "Courtroom Public Gallery"
	})
"KO" = (
/obj/stool/chair/office{
	dir = 8
	},
/obj/machinery/light/incandescent{
	dir = 4
	},
/turf/simulated/floor/carpet/green/fancy/edge/se,
/area/station/crew_quarters/courtroom{
	name = "Jury Conference Room"
	})
"Lk" = (
/obj/reagent_dispensers/watertank/fountain,
/turf/simulated/floor/wood,
/area/station/crew_quarters/courtroom{
	name = "Jury Conference Room"
	})
"Lz" = (
/obj/stool/chair/office{
	dir = 4
	},
/obj/item/device/radio/intercom/security{
	dir = 4
	},
/turf/simulated/floor/carpet/green/fancy/edge/sw,
/area/station/crew_quarters/courtroom{
	name = "Jury Conference Room"
	})
"LL" = (
/obj/item/device/radio/intercom/security{
	dir = 4
	},
/turf/simulated/floor/carpet/red/fancy/edge/nw,
/area/station/crew_quarters/courtroom)
"Mi" = (
/obj/loudspeaker,
/turf/simulated/floor/wood,
/area/station/crew_quarters/courtroom)
"Mj" = (
/obj/table/wood/auto,
/obj/item/clipboard/with_pen{
	pixel_y = 4
	},
/obj/item/paper_bin{
	pixel_y = 3
	},
/obj/item/pen{
	pixel_y = 4
	},
/turf/simulated/floor/carpet/green/fancy,
/area/station/crew_quarters/courtroom{
	name = "Jury Conference Room"
	})
"Mr" = (
/obj/stool/chair/comfy{
	dir = 1
	},
/turf/simulated/floor/carpet/blue/fancy,
/area/station/crew_quarters/courtroom)
"MO" = (
/obj/table/wood/auto/desk{
	icon_state = "1"
	},
/obj/item/device/audio_log/radioship/large,
/turf/simulated/floor/carpet/blue/fancy/edge/east,
/area/station/crew_quarters/courtroom)
"MV" = (
/obj/stool/chair/office/blue,
/turf/simulated/floor/carpet/blue/fancy/edge/ne,
/area/station/crew_quarters/courtroom)
"Nw" = (
/obj/table/wood/auto,
/obj/item/audio_tape,
/turf/simulated/floor/carpet/green/fancy/edge/south,
/area/station/crew_quarters/courtroom{
	name = "Jury Conference Room"
	})
"Og" = (
/obj/stool/chair/office{
	dir = 4
	},
/obj/machinery/light/incandescent{
	dir = 8
	},
/turf/simulated/floor/carpet/green/fancy/edge/west,
/area/station/crew_quarters/courtroom{
	name = "Jury Conference Room"
	})
"OS" = (
/obj/stool/chair/office{
	dir = 8
	},
/obj/machinery/light/incandescent{
	dir = 4
	},
/turf/simulated/floor/carpet/green/fancy/edge/east,
/area/station/crew_quarters/courtroom)
"Pn" = (
/obj/item/clipboard/with_pen{
	pixel_y = 4
	},
/obj/item/paper_bin{
	pixel_y = 3
	},
/obj/item/pen{
	pixel_y = 4
	},
/obj/table/wood{
	icon_state = "1"
	},
/turf/simulated/floor/carpet/green/fancy/edge/sw,
/area/station/crew_quarters/courtroom)
"Ql" = (
/obj/stool/chair/office{
	dir = 8
	},
/obj/decoration/clock{
	pixel_x = 32
	},
/turf/simulated/floor/carpet/green/fancy/edge/east,
/area/station/crew_quarters/courtroom{
	name = "Jury Conference Room"
	})
"Rs" = (
/obj/table/reinforced,
/obj/item/clipboard/with_pen{
	pixel_y = 4
	},
/obj/item/paper_bin{
	pixel_y = 3
	},
/obj/item/pen{
	pixel_y = 4
	},
/obj/machinery/light/incandescent,
/turf/simulated/floor/carpet/red/fancy/edge/se,
/area/station/crew_quarters/courtroom)
"RF" = (
/obj/firedoor_spawn,
/obj/machinery/door/airlock/pyro/security/alt,
/obj/access_spawn/security,
/obj/machinery/secscanner{
	pixel_y = 9
	},
/turf/simulated/floor/wood,
/area/station/crew_quarters/courtroom)
"RR" = (
/obj/table/wood/auto/desk{
	icon_state = "12"
	},
/obj/item/toy/judge_block{
	pixel_y = 4
	},
/obj/item/toy/judge_gavel{
	pixel_x = -5;
	pixel_y = 3
	},
/turf/simulated/floor/carpet/blue/fancy/edge/north,
/area/station/crew_quarters/courtroom)
"Sl" = (
/turf/simulated/floor/carpet/blue/fancy/edge/se,
/area/station/crew_quarters/courtroom)
"Sz" = (
/obj/storage/closet/office,
/turf/simulated/floor/wood,
/area/station/crew_quarters/courtroom)
"Tl" = (
/obj/stool/chair/office/blue,
/turf/simulated/floor/carpet/blue/fancy/edge/nw,
/area/station/crew_quarters/courtroom)
"UO" = (
/obj/table/wood/auto/desk{
	icon_state = "6"
	},
/obj/item/clipboard/with_pen{
	pixel_y = 4
	},
/obj/item/paper_bin{
	pixel_y = 3
	},
/obj/item/pen/fancy{
	pixel_y = 4
	},
/turf/simulated/floor/carpet/blue/fancy/edge/nw,
/area/station/crew_quarters/courtroom)
"Vr" = (
/obj/machinery/light/incandescent,
/turf/simulated/floor/wood,
/area/station/crew_quarters/courtroom)
"VM" = (
/obj/item/clipboard/with_pen{
	pixel_y = 4
	},
/obj/item/paper_bin{
	pixel_y = 3
	},
/obj/item/pen{
	pixel_y = 4
	},
/obj/table/wood{
	icon_state = "8"
	},
/turf/simulated/floor/carpet/red/fancy/edge/east,
/area/station/crew_quarters/courtroom)
"VR" = (
/obj/item/storage/wall/office{
	dir = 8;
	pixel_x = 32;
	pixel_y = 0
	},
/turf/simulated/floor/wood,
/area/station/crew_quarters/courtroom{
	name = "Jury Conference Room"
	})
"Wp" = (
/obj/table/wood/auto/desk{
	icon_state = "1"
	},
/obj/item/clothing/suit/judgerobe,
/obj/item/clothing/head/powdered_wig{
	pixel_y = 11
	},
/turf/simulated/floor/carpet/blue/fancy/edge/west,
/area/station/crew_quarters/courtroom)
"Wz" = (
/obj/stool/chair/red{
	dir = 4
	},
/turf/simulated/floor/carpet/red/fancy/edge/ne,
/area/station/crew_quarters/courtroom)
"WW" = (
/obj/table/wood/auto,
/obj/item/folder,
/turf/simulated/floor/carpet/green/fancy,
/area/station/crew_quarters/courtroom{
	name = "Jury Conference Room"
	})
"Xe" = (
/turf/space,
/area/space)
"Xr" = (
/turf/simulated/floor/carpet/red/fancy/edge/ne,
/area/station/crew_quarters/courtroom)
"Ye" = (
/obj/machinery/light/incandescent{
	dir = 1
	},
/obj/table/wood{
	icon_state = "3"
	},
/turf/simulated/floor/carpet/green/fancy/edge/nw,
/area/station/crew_quarters/courtroom)

(1,1,1) = {"
za
za
za
za
za
za
za
wU
wU
sC
wU
Xe
"}
(2,1,1) = {"
zl
JV
wW
JG
pU
wW
tR
lE
LL
fX
wU
Xe
"}
(3,1,1) = {"
zl
kh
iw
iw
iw
iw
xE
lE
Wz
Rs
wU
Xe
"}
(4,1,1) = {"
za
qB
qB
qB
qB
qB
qB
lE
lE
lE
wU
Xe
"}
(5,1,1) = {"
lE
pL
Bg
pL
pL
pL
Bg
pL
pL
pL
RF
Xe
"}
(6,1,1) = {"
lE
Tl
jx
HB
pL
UO
Wp
HB
pL
Vr
wU
Xe
"}
(7,1,1) = {"
lE
MV
an
Sl
pL
RR
Mr
Cw
pL
pL
wU
Xe
"}
(8,1,1) = {"
iO
pL
pL
eI
pL
BB
MO
Sl
pL
Ik
wU
wU
"}
(9,1,1) = {"
iO
pL
pL
pL
pL
pL
eI
pL
pL
xd
ff
wU
"}
(10,1,1) = {"
lE
cy
cB
fX
xM
dH
wA
Hm
pL
pg
mS
wU
"}
(11,1,1) = {"
lE
lh
VM
Ab
Mi
fe
fl
gw
pL
Xr
Ab
wU
"}
(12,1,1) = {"
lE
pL
pL
pL
pL
pL
pL
pL
Sz
wU
wU
wU
"}
(13,1,1) = {"
wU
Ye
iE
iE
iE
jG
Pn
pL
Gy
wU
Xe
Xe
"}
(14,1,1) = {"
wU
yO
FN
OS
fl
fl
sy
pL
ua
wU
Xe
Xe
"}
(15,1,1) = {"
wU
wU
wU
wU
wU
wU
wU
fn
wU
wU
Xe
Xe
"}
(16,1,1) = {"
Xe
Xe
zC
DJ
Og
Lz
gl
BQ
FJ
Xe
Xe
Xe
"}
(17,1,1) = {"
Xe
Xe
zC
DK
Mj
rc
kO
rA
FJ
Xe
Xe
Xe
"}
(18,1,1) = {"
Xe
Xe
zC
DK
WW
Nw
kO
ch
FJ
Xe
Xe
Xe
"}
(19,1,1) = {"
Xe
Xe
zC
Fd
Ql
KO
VR
Lk
FJ
Xe
Xe
Xe
"}
(20,1,1) = {"
Xe
Xe
FJ
FJ
FJ
FJ
FJ
FJ
FJ
Xe
Xe
Xe
"}
