//MAP CONVERTED BY dmm2tgm.py THIS HEADER COMMENT PREVENTS RECONVERSION, DO NOT REMOVE
"aq" = (
/obj/machinery/chem_dispenser/alcohol,
/turf/simulated/floor/black,
/area/station/crew_quarters/jazz)
"bz" = (
/obj/table/wood/auto,
/obj/item/dice{
	pixel_x = 2;
	pixel_y = 13
	},
/obj/item/dice{
	pixel_x = 9;
	pixel_y = 10
	},
/obj/item/card_box/suit{
	pixel_x = -8;
	pixel_y = 6
	},
/obj/item/clothing/head/flatcap{
	pixel_x = 2;
	pixel_y = -2
	},
/turf/simulated/floor/black,
/area/station/crew_quarters/jazz)
"bF" = (
/obj/shrub,
/obj/item/seed/cannabis{
	pixel_x = -2;
	pixel_y = 1
	},
/obj/item/seed/cannabis{
	pixel_x = 6;
	pixel_y = 6
	},
/turf/simulated/floor/black,
/area/station/crew_quarters/jazz)
"bJ" = (
/obj/stool/chair/comfy{
	dir = 8
	},
/turf/simulated/floor/carpet/purple/fancy/innercorner/se,
/area/station/crew_quarters/jazz)
"fy" = (
/obj/stool/chair/comfy{
	dir = 4
	},
/turf/simulated/floor/carpet/purple/fancy/innercorner/sw,
/area/station/crew_quarters/jazz)
"fV" = (
/obj/cable{
	icon_state = "1-2"
	},
/obj/machinery/door/airlock/pyro/glass{
	name = "One-South"
	},
/obj/firedoor_spawn,
/turf/simulated/floor/black,
/area/station/crew_quarters/jazz)
"gO" = (
/turf/simulated/floor/black,
/area/station/crew_quarters/jazz)
"hp" = (
/obj/machinery/light/small/floor,
/obj/table/wood/auto,
/obj/item/clothing/glasses/sunglasses{
	pixel_x = -2;
	pixel_y = -6
	},
/obj/item/paper_bin{
	pixel_x = -1;
	pixel_y = 6
	},
/obj/item/pen{
	pixel_x = -2;
	pixel_y = 6
	},
/turf/simulated/floor/black,
/area/station/crew_quarters/jazz)
"iz" = (
/obj/stool/chair/comfy{
	dir = 8
	},
/turf/simulated/floor/carpet/purple/fancy/innercorner/ne,
/area/station/crew_quarters/jazz)
"jb" = (
/obj/stool/bench/wooden/auto,
/turf/simulated/floor/wood,
/area/station/crew_quarters/jazz)
"jD" = (
/obj/table/reinforced/bar/auto,
/obj/machinery/microwave{
	pixel_y = 2
	},
/turf/simulated/floor/black,
/area/station/crew_quarters/jazz)
"kj" = (
/turf/simulated/floor/carpet/purple/fancy/innercorner/ne,
/area/station/crew_quarters/jazz)
"lz" = (
/turf/simulated/floor/carpet/purple/fancy/edge/nw,
/area/station/crew_quarters/jazz)
"lJ" = (
/obj/shrub,
/turf/simulated/floor/black,
/area/station/crew_quarters/jazz)
"mG" = (
/turf/simulated/floor/carpet/purple/fancy/edge/sw,
/area/station/crew_quarters/jazz)
"nB" = (
/obj/wingrille_spawn/auto,
/obj/wingrille_spawn/auto,
/turf/simulated/floor/plating,
/area/station/crew_quarters/jazz)
"oK" = (
/obj/cable{
	icon_state = "4-8"
	},
/obj/machinery/camera{
	c_tag = "autotag";
	dir = 6;
	name = "autoname - SS13";
	tag = ""
	},
/turf/simulated/floor/black,
/area/station/crew_quarters/jazz)
"qe" = (
/turf/simulated/floor/carpet/purple,
/area/station/crew_quarters/jazz)
"rc" = (
/turf/simulated/floor/carpet/purple/fancy/innercorner/north,
/area/station/crew_quarters/jazz)
"rw" = (
/obj/item/instrument/large/jukebox,
/turf/simulated/floor/carpet/purple/fancy/edge/se,
/area/station/crew_quarters/jazz)
"sf" = (
/obj/table/reinforced/bar/auto,
/turf/simulated/floor/black,
/area/station/crew_quarters/jazz)
"sK" = (
/turf/simulated/wall/auto/supernorn,
/area/station/crew_quarters/jazz)
"tO" = (
/turf/simulated/wall/auto/reinforced/supernorn,
/area/station/crew_quarters/jazz)
"uC" = (
/obj/table/reinforced/bar/auto,
/obj/machinery/glass_recycler{
	density = 1;
	pixel_y = 4
	},
/turf/simulated/floor/black,
/area/station/crew_quarters/jazz)
"uF" = (
/obj/table/wood/auto,
/obj/item/device/light/zippo{
	pixel_x = 7;
	pixel_y = 7
	},
/obj/item/device/light/zippo{
	pixel_x = 5;
	pixel_y = 2
	},
/obj/item/cigpacket{
	pixel_x = -5;
	pixel_y = 8
	},
/obj/item/cigpacket{
	pixel_x = -6;
	pixel_y = 5
	},
/obj/item/cigpacket{
	pixel_x = -7;
	pixel_y = 2
	},
/turf/simulated/floor/black,
/area/station/crew_quarters/jazz)
"wY" = (
/turf/simulated/floor/carpet/purple/fancy/edge/se,
/area/station/crew_quarters/jazz)
"xd" = (
/obj/item/device/radio/intercom{
	dir = 4;
	name = "Station Intercom"
	},
/obj/table/wood/auto,
/obj/item/instrument/saxophone{
	pixel_y = 8
	},
/obj/item/instrument/harmonica{
	pixel_x = -5;
	pixel_y = 4
	},
/obj/item/instrument/guitar{
	pixel_x = 5
	},
/turf/simulated/floor/wood,
/area/station/crew_quarters/jazz)
"yt" = (
/obj/machinery/light/small,
/turf/simulated/floor/stairs/wood{
	dir = 4
	},
/area/station/crew_quarters/jazz)
"zj" = (
/turf/simulated/floor/carpet/purple/fancy/innercorner/se,
/area/station/crew_quarters/jazz)
"zt" = (
/obj/machinery/power/apc/autoname_south,
/obj/cable{
	icon_state = "0-4"
	},
/turf/simulated/floor/black,
/area/station/crew_quarters/jazz)
"zw" = (
/obj/cable{
	icon_state = "2-8"
	},
/turf/simulated/floor/black,
/area/station/crew_quarters/jazz)
"zN" = (
/turf/simulated/floor/wood,
/area/station/crew_quarters/jazz)
"AT" = (
/obj/decal/tile_edge/stripe{
	dir = 9;
	tag = ""
	},
/turf/simulated/floor/wood,
/area/station/crew_quarters/jazz)
"CZ" = (
/obj/decal/tile_edge/stripe{
	dir = 1
	},
/obj/mic_stand,
/turf/simulated/floor/wood,
/area/station/crew_quarters/jazz)
"De" = (
/obj/decal/tile_edge/stripe{
	dir = 5
	},
/turf/simulated/floor/wood,
/area/station/crew_quarters/jazz)
"Fb" = (
/turf/simulated/floor/carpet/purple/fancy/innercorner/sw,
/area/station/crew_quarters/jazz)
"FJ" = (
/turf/simulated/floor/carpet/purple/fancy/edge/ne,
/area/station/crew_quarters/jazz)
"Gm" = (
/obj/table/wood/auto,
/obj/item/game_kit{
	pixel_y = 4
	},
/turf/simulated/floor/carpet/purple,
/area/station/crew_quarters/jazz)
"Hm" = (
/obj/machinery/chem_dispenser/soda,
/turf/simulated/floor/black,
/area/station/crew_quarters/jazz)
"HB" = (
/obj/table/wood/auto,
/obj/machinery/light/small/floor,
/obj/item/clothing/head/flatcap{
	pixel_x = -6;
	pixel_y = 10
	},
/obj/item/instrument/tambourine{
	pixel_x = 5;
	pixel_y = 6
	},
/obj/item/instrument/triangle{
	pixel_x = -3;
	pixel_y = 4
	},
/turf/simulated/floor/black,
/area/station/crew_quarters/jazz)
"HG" = (
/obj/cable{
	icon_state = "1-2"
	},
/turf/simulated/floor/black,
/area/station/crew_quarters/jazz)
"HH" = (
/obj/item/instrument/large/piano/grand,
/turf/simulated/floor/wood,
/area/station/crew_quarters/jazz)
"Mi" = (
/turf/space,
/area/space)
"MN" = (
/obj/stool/chair/comfy{
	dir = 4
	},
/turf/simulated/floor/carpet/purple/fancy/innercorner/nw,
/area/station/crew_quarters/jazz)
"MP" = (
/turf/simulated/floor/carpet/purple/fancy/innercorner/nw,
/area/station/crew_quarters/jazz)
"Of" = (
/turf/simulated/floor/carpet/purple/fancy/edge/north,
/area/station/crew_quarters/jazz)
"Pf" = (
/obj/machinery/light/small{
	dir = 1
	},
/turf/simulated/floor/black,
/area/station/crew_quarters/jazz)
"QB" = (
/obj/decal/tile_edge/stripe{
	dir = 1
	},
/turf/simulated/floor/wood,
/area/station/crew_quarters/jazz)
"RA" = (
/obj/cable{
	icon_state = "1-8"
	},
/turf/simulated/floor/black,
/area/station/crew_quarters/jazz)
"So" = (
/turf/simulated/floor/carpet/purple/fancy/innercorner/south,
/area/station/crew_quarters/jazz)
"SD" = (
/obj/table/reinforced/bar/auto,
/obj/item/decoration/ashtray{
	butts = 1;
	pixel_x = 8;
	pixel_y = 11
	},
/turf/simulated/floor/black,
/area/station/crew_quarters/jazz)
"Tk" = (
/obj/machinery/firealarm{
	pixel_y = 24
	},
/turf/simulated/floor/black,
/area/station/crew_quarters/jazz)
"Ud" = (
/obj/wingrille_spawn/auto,
/turf/simulated/floor/plating,
/area/station/crew_quarters/jazz)
"Uq" = (
/obj/cable{
	icon_state = "1-4"
	},
/turf/simulated/floor/black,
/area/station/crew_quarters/jazz)
"YX" = (
/obj/machinery/light/small,
/obj/decal/tile_edge/stripe{
	dir = 4
	},
/turf/simulated/floor/wood,
/area/station/crew_quarters/jazz)
"ZN" = (
/obj/table/wood/auto,
/obj/item/reagent_containers/food/drinks/drinkingglass/wine{
	pixel_x = 8;
	pixel_y = 6
	},
/obj/item/reagent_containers/food/drinks/drinkingglass/wine{
	pixel_x = -8;
	pixel_y = 6
	},
/obj/item/reagent_containers/food/drinks/bottle/ntbrew{
	pixel_y = 11
	},
/turf/simulated/floor/carpet/purple,
/area/station/crew_quarters/jazz)
"ZU" = (
/obj/stool/bar,
/turf/simulated/floor/black,
/area/station/crew_quarters/jazz)

(1,1,1) = {"
Mi
Mi
Mi
Mi
Mi
Mi
Mi
Mi
Mi
Mi
Mi
Mi
Mi
Mi
Mi
Mi
Mi
Mi
Mi
Mi
"}
(2,1,1) = {"
Mi
Mi
Mi
Mi
Mi
Mi
Mi
Mi
Mi
Mi
Mi
Mi
Mi
Mi
Mi
Mi
Mi
Mi
Mi
Mi
"}
(3,1,1) = {"
Mi
Mi
Mi
Mi
Mi
Mi
Mi
Mi
Mi
Mi
Mi
Mi
Mi
Mi
Mi
Mi
Mi
Mi
Mi
Mi
"}
(4,1,1) = {"
Mi
Mi
Mi
Mi
Mi
Mi
Mi
Mi
Mi
tO
Ud
Ud
Ud
Mi
Mi
Mi
Mi
Mi
Mi
Mi
"}
(5,1,1) = {"
Mi
Mi
Mi
Mi
Mi
Mi
Mi
Mi
Mi
tO
bz
HB
Ud
Ud
Ud
Mi
Mi
Mi
Mi
Mi
"}
(6,1,1) = {"
Mi
Mi
Mi
Mi
Mi
Mi
Mi
Mi
tO
tO
Tk
gO
lz
mG
Ud
Ud
Mi
Mi
Mi
Mi
"}
(7,1,1) = {"
Mi
Mi
Mi
Mi
Mi
tO
tO
tO
tO
lJ
gO
gO
Of
Fb
mG
Ud
Ud
Mi
Mi
Mi
"}
(8,1,1) = {"
Mi
Mi
Mi
Mi
Mi
sK
jD
gO
sf
ZU
gO
lz
MN
qe
Fb
mG
Ud
Mi
Mi
Mi
"}
(9,1,1) = {"
Mi
Mi
Mi
Mi
Mi
sK
aq
gO
sf
ZU
gO
Of
ZN
qe
AT
yt
tO
tO
Mi
Mi
"}
(10,1,1) = {"
Mi
Mi
Mi
Mi
Mi
sK
Hm
gO
SD
ZU
gO
Of
bJ
kj
QB
zN
xd
Ud
Mi
Mi
"}
(11,1,1) = {"
Mi
Mi
Mi
Mi
Mi
sK
uC
zt
sK
Pf
gO
Of
So
rc
QB
zN
jb
nB
Mi
Mi
"}
(12,1,1) = {"
Mi
Mi
Mi
Mi
Mi
sK
Tk
zw
HG
Uq
gO
Of
fy
MP
CZ
zN
HH
Ud
Mi
Mi
"}
(13,1,1) = {"
Mi
Mi
Mi
Mi
Mi
sK
sK
sK
sK
oK
gO
Of
Gm
qe
De
YX
tO
tO
Mi
Mi
"}
(14,1,1) = {"
Mi
Mi
Mi
Mi
Mi
HG
HG
fV
HG
RA
gO
FJ
iz
qe
zj
rw
Ud
Mi
Mi
Mi
"}
(15,1,1) = {"
Mi
Mi
Mi
Mi
Mi
tO
tO
tO
tO
bF
gO
gO
Of
zj
wY
Ud
Ud
Mi
Mi
Mi
"}
(16,1,1) = {"
Mi
Mi
Mi
Mi
Mi
Mi
Mi
Mi
tO
tO
gO
gO
FJ
wY
Ud
Ud
Mi
Mi
Mi
Mi
"}
(17,1,1) = {"
Mi
Mi
Mi
Mi
Mi
Mi
Mi
Mi
Mi
tO
uF
hp
Ud
Ud
Ud
Mi
Mi
Mi
Mi
Mi
"}
(18,1,1) = {"
Mi
Mi
Mi
Mi
Mi
Mi
Mi
Mi
Mi
tO
Ud
Ud
Ud
Mi
Mi
Mi
Mi
Mi
Mi
Mi
"}
(19,1,1) = {"
Mi
Mi
Mi
Mi
Mi
Mi
Mi
Mi
Mi
Mi
Mi
Mi
Mi
Mi
Mi
Mi
Mi
Mi
Mi
Mi
"}
(20,1,1) = {"
Mi
Mi
Mi
Mi
Mi
Mi
Mi
Mi
Mi
Mi
Mi
Mi
Mi
Mi
Mi
Mi
Mi
Mi
Mi
Mi
"}
